contra las cuerdas : dos au mur
cantera : carrière (marbre)
marmol : marbre
los pormenores de : les tenants et aboutissants
higuera : figuier
obispo : évêque
cedro : cèdre
nave : hangar
esquilon : cloche
legua : lieue (mesure, distance)
testero : paroi
ruisenor : rossignol
ciprés : cyprès
batir los dientes : claquer des dents
velon : lampe à huile
cinta : film
ojota : sandale
erizo : hérisson
pincho : amuse-gueule
ostra : huître
opiaceo : opiacé
seto : haie
boqueron : anchois
adobo : marinade
relamerse : se lécher les babines
comensal : convive
prostibulo : maison close, bordel
almendro : amandier
rescoldo : dernières braises
trebedes : trépied
pazo : maison de campagne
madrena : sabot
valla : clôture
enrejado : grille
agazaparse : se tapir
patilla : branche (lunnettes)
decimo : ticket de loterie
engorro : pénible, embêtant, casse-pieds
aguilucho : aiglon
acecho : guet
pelagatos : pauvre diable
sastreria : atelier de tailleur
chatarra : ferraille
ferreteria : quincaillerie
resobaso : vu et revu
jiron : lambeau
reniego : blasphème
chatarrero : ferrailleur
pasto : pâturage
empolvar : poudrer
carantonas : mamours
campanario : clocher
michelin : bourrelet, poignées d'amour
bosquecillo : bosquet, petit bois
sepelios : obsèques, funérailles
tanatorio : funérarium, chambre funéraire
pulcritud : soin, ordre
los chorros del oro : pimpant, nettoyé à fond
zaguan : entrée, vestibule
rienda : rêne
chiringuito : bar de plage
manjar : mets exquis
alcornoque : chêne-liège
larguirucho : grand dadais
enmienda : amendement
pleno : séance plénière
seda : soie
