eterno : éternel
joya : bijou, joyau
hallar : trouver, retrouver, découvrir
zurdo : gaucher
recorrer : parcourir, traverser
florecer : fleurir
pie : pied
reflejar : refléter
fantasma : fantôme
higado : foie
palido : pâle
suspirar : soupirer
oloroso : odorant
huella : empreinte, trace
concluir : terminer, finir, conclure
traicionar : trahir
flaco : maigre
el humo : la fumée
rodilla : genou
caballo : cheval
gallina : poule
lagrimas : larmes
alegre : joyeux
nivel : niveau
factura : facture
septiembre : septembre
atraer : attirer
sombrio : sombre, obscur
vuelo : vol (oiseau, avion)
cucharita : petite cuillère
entregar : remettre, livrer, confier
terreno : terrain
falda : jupe
enero : janvier
alla : là-bas
vaciar : vider
pareza : paresse
piel : peau
pierna : jambe
conceder : accorder, concéder, octroyer
risa : rire
yerba : herbe
virtud : vertu
gritar : crier
complaciente : serviable, aimable
amanecer : lever du soleil
cuerda : corde
lapiz : crayon
febrero : février
cubrir : couvrir, recouvrir
ausencia : absence
detener : arrêter, stopper
milagro : miracle
gastar tiempo en : perder son temps à
vistazo : coup d'oeil
mochila : sac à dos
quieto : tranquille
dicho : ce
huida : fuite
abril : avril
empezar : commencer
condicion : condition
siquiera : même pas
cierto : vrai, véridique
noticia : nouvelle, information
informe : rapport
condena : peine, condamnation
notar : remarquer, se rendre compte
llevar : porter, emporter
angustia : angoisse
echar : jeter
presuroso : rapide
alegremente : joyeusement
casco : casque
marzo : mars
prisa : hâte, empressement
diferencia : différence
socio : associé
caro : cher, coûteux
discurso : discours
ministro : ministre
por lo tanto : donc, par conséquent
reproche : reproche
apoyar : soutenir
carcel : prison
abogado : avocat
compartir : partager
buscar : chercher
barato : pas cher, bon marché
soler : avoir l'habitude de
parecer : sembler, paraître
futuro : futur
opcion : option, choix
cabeza : tête
ayudar : aider
menor : plus petit
subir : monter
desde : depuis
contestar : répondre
ley : loi
mayo : mai
silla : chaise
mesa : table
cuidar : garder, surveiller
pesar : peser
encima : dessus
siquiera : au moins
cuchillo : couteau
carnicero : boucher
cuchara : cuillère
charcutero : charcutier
panaderia : boulangerie
encender : allumer
madurar : mûrir
tal vez : peut-être
disparar : tirer (avec une arme)
acostumbrar : habituer à
cerdo : porc, cochon
teta : sein, nichon
entrega : livraison