diestro : droiter, adroit, habile
incierto : faux, incertain
tutear : tutoyer
cazar : chasser, attraper, capturer
rosal : rosier
lago : lac
huella : empreinte
apuntar : indiquer, pointer, montrer
fallo : erreur
estante : étagère
vomitar : vomir
probar : tester
improviso : imprévu
atreverse : oser
cabron : enfoiré, salaud
molestar : déranger
intentar : tenter
melena : chevelure
tragar : avaler
relajar : détendre, calmer
perjudicial : nuisible, néfaste
lamentar : regretter, déplorer
ave : oiseau
producir : produire
colocar : placer, poser
basura : poubelle
dibujar : dessiner
levemente : légèrement
muslo : cuisse
calcetin : chaussette
sangre : sang
plato : assiette
compadecer : plaindre
alfombra : tapis
escalera : escalier
nietos : petits-enfants
liberar : libérer
semejante : tel, telle
nariz : nez
diente : dent
vecino : voisin
cima : sommet
agobio : stress, angoisse
plantearse : envisager, considérer
paliza : correction, raclée, branlée
desconsolar : bouleverser, attrister
impotencia : impuissance
nevera : réfrigirateur
mantequilla : beurre
repetir : refaire, recommencer
relevo : relève
abstenerse : s'abstenir
comedor : salle à manger
corriente : courant
audacia : audace
librar : préserver de, protéger de
prado : pré
camisa : chemise
dentista : dentiste
doctor : médecin
moreno : bronzé
terraza : terrasse
traje : costume
ojo : œil
libro : livre
labio : lèvre
nariz : nez
una : ongle
golpe : coup
prorrogar : prolonger
cartera : portefeuille
seguidamente : aussitôt
leccion : leçon
tarea : tâche
declarar : déclarer
promesa : promesse
responsabilidad : responsabilité
acompanar : accompagner
cambio : changement
ambito : domaine, secteur, milieu
nombramiento : nomination
asegurar : assurer, garantir
desacuerdo : désaccord
prueba : preuve
destruir : détruire
administrar : administrer, diriger
arriesgar : risquer
tratamiento : traitement
porcentaje : pourcentage
aproximadamente : environ, approximativement
asimismo : de même, aussi
recaida : rechute
cuerpo : corp
vida : vie
lluvia : pluie
unidad : unité
desaparecer : disparaître
torrente : torrent
robar : voler (dérober)
isla : île
volar : voler (en l'air)
viento : vent
mismo : même
nadar : nager
belleza : beauté
pese a : malgré
inmenso : immense
merced : merci
empujar : pousser
pesimo : piètre, très mauvais
dondequiera : où que ce soit
soplar : souffler
atmosfera : atmosphère
grueso : gros, épais
ajo : ail
demonio : diable, démon
maloliente : malodorant
sencillez : simplicité
potencia : puissance
competencia : concurrence
arbitro : arbitre
excluir : exclure
arrodillar : s'agenouiller
juguete : jouet
habilitar : aménager, habiliter
feroz : féroce
hipocresia : hypocrisie
azucar : sucre
ajo : ail
defecto : défaut
panuelo : mouchoir
mezquino : mesquin
telediario : journal télévisé
conjunto : ensemble
empresario : chef d'entreprise
estrategia : stratégie
ladron : voleur
respuesta : réponse
previsto : prévu
novedad : nouveauté
suficiente : suffisant
aprobar : adopter, réussir
preventivo : préventif
paraguas : parapluie
contraccion : contraction
desaceleracion : ralentissement, décélération
petroleo : pétrole
temor : crainte, peur
mono : singe
dueno : propriétaire
fregadero : évier
madrugar : se lever tôt
encabronarse : s'énerver
pasillo : couloir
ladrillo : brique
corbata : cravate
chulo : super, chouette
pastel : gâteau
ingresar : entrer dans, intégrer
grabar : enregistrer, filmer
merienda : goûter
aconsejar : conseiller
parar : arrêter
carretera : route
componer : composer
espejo : miroir
denuncia : plainte
enterar : aviser, notifier, informer
apostar : parier
coger : prendre
cuaderno : cahier de brouillon
vaciar : vider
contratar : embaucher
cortar : couper
alegrarse : se réjouir
lealtad : loyauté
muneca : poignet
ambicion : ambition
un tenedor : une fouchette
almorzar : déjeuner
pinchar : crever
suegra : belle-mère (mère du conjoint)
pesca : pêche
humilde : humble
naufragio : naufrage
ambiente : ambiance
desarrollar : développer, réaliser, mener à bien
comprometerse : s'engager
borrar : effacer
relatar : raconter
ambos : les deux
maletero : coffre (voiture)
madastra : belle-mère (nouvelle femme du père)
encajar : aller à quelqu'un, coincider avec
cruzar : traverser
sorprender : surprendre
sueldo : salaire
emocioner : émouvoir
enhorabuena : félicitation
norma : règle
planta : étage
majo : mignon, joli
barbacoa : barbecue, grillade
cantante : chanteur
revolver : mélanger
bandera : drapeau
saltar : sauter
rendir : vaincre
trampa : piège
imponer : imposer
abajo : dessous, en bas
alguna vez : quelque fois
trauma : traumatisme
burbuja : bulle
valiente : courageux
obviar : omettre, oublier
acuerdo : compromis
consentimiento : consentement, accord
teclado : clavier
estudiar : étudier
cargar : charger
cruzar : croiser
lograr : réussir à, parvenir à
cuidado : soin, attention
bolsillo : poche
injusto : injuste
fijo : fixe
cangrejo : crabe
centenar : centaine
secuela : séquelle
envidia : envie, jalousie
pitar : siffler
esperar : attendre
pelirrojo : roux
averiguar : découvrir, chercher à savoir
estancia : séjour, pièce
desvelar : dévoiler, révéler
barrer : balayer
esbelto : svelte
honradez : honnêteté