camello : chameau
obviamente : évidemment
huevo : oeuf
pecho : poitrine
danar : abîmer, endommager
nube : nuage
extranar : manquer à
sondeo : sondage
quiebra : effondrement, faillite
fastidiar : ennuyer, énerver, embêter
satisfacer : satisfaire
sustituto : remplaçant
taller : garage
pescar : pêcher
alejar : éloigner
oficina : bureau
exito : succès
fracaso : échec
alegre : gai, joyeux
rechazar : rejeter, refuser
oler : sentir
pertenecer : appartenir
defectuoso : défectueux
tirar : lancer, jeter
pesadilla : cauchemar
mosca : mouche
tamano : taille
antiguo : vieux, ancien
audiencia : audience
permanecer : rester, demeurer
planta baja : rez de chaussée
mejilla : joue
cruzar : croiser
improvisar : improviser
frontera : frontière
odiar : détester, haïr
agotado : épuisé
acostumbrarse : s'habituer
cielo : chéri
traer : apporter, amener
retrasar : retarder, reporter
presuponer : présupposer
gasolina : essence
complacer : faire plaisir, satisfaire
animar : encourager
cuyo : dont
fraude : fraude
ayuntamiento : mairie
ciudadano : citoyen
alcalde : maire
ubicacion : localisation, lieu
planta : plante
homicidio : homicide
menor : mineur
medio ambiente : environnement
contaminacion : pollution
ambiente : air
afortunadamente : heureusement
pera : poire
ciudad : ville
manzana : pomme
sentido comun : bon sens
reprimenda : réprimante
obedecer : obéir
potente : puissant
servilleta : serviette de table
ambiente : environnement, entourage
postrero : dernier
pradera : prairie
dominio : pouvoir, domination
apuntar : noter
atar : attacher
esquina : coin
huir : fuir
gallo : coq
aldea : village, hameau
lentitud : lenteur
medroso : peureux, effrayant
nuera : belle-fille
retocar : retoucher
estandar : standard
puno : poing
alojar : loger
susto : peur, frayeur
extranar : surprendre
recibidor : entrée, vestibule
