hablar : parler
caminar : marcher
cantar : chanter
salir : sortir
beber : boire
ver : voir
cuidar : s'occuper de, prendre soin de
escribir : écrire
hacer : faire
querer : vouloir
cambiar : changer
banca : banque
sacar : sortir, extraire
conducir : conduire
saltar : sauter
volver : revenir, rentrer
rescatar : sauver
arrancar : démarrer
dejar : arrêter
golpear : frapper, battre
herida : blessure
palabra : mot
frase : phrase
cuaderno : cahier
ordenador : ordinateur
ventana : fenêtre
pelo : cheveux
bigote : moustache
oreja : oreille
cama : lit
mueble : meuble
decir : dire
facil : facile
dificil : difficile
castillo : château
duda : doute
rabia : colère
puente : pont
recoger : rammasser, aller chercher
autopista : autoroute
desmayar : faiblir
retrato : portrait
semanal : hebdomadaire
aparcar : garer
dato : donnée, information
sostener : tenir, soutenir
delito : délit, crime
prensa : presse
cementerio : cimetière
bajo : bas
desgracia : malheur
turbio : trouble
boda : mariage
mano : main
alma : âme
vina : vigne
platano : banane
piedra : pierre
campana : campagne
tardar : être en retard, mettre du temps
recordar : rappeler
cesped : gazon, pelouse
vulgar : vulgaire
maldicion : malédiction
concebir : concevoir
salud : santé
mando : télécommande
hueso : os
asunto : sujet, affaire
notificar : notifier
fallecer : décéder, mourir
dedo : doigt
llevar a cabo : mener à bien
rechazar : refuser
casualidad : hasard
mediodia : midi
patio : cour, cour intérieure
preceder : précéder
presagio : présage
ropa : vêtements
devolver : rendre, redonner
contradecir : contredire, démentir
toalla : serviette
pajaro : oiseau
hogar : foyer, intérieur
vivienda : logement
bruja : sorcière
suplicar : supplier
delito : délit, crime
verano : été
entrevista : entretien
agotar : épuiser, exténuer
odio : haine
tomar medidas : prendre des mesures
regresar : rentrer, revenir
advertir : prévenir, avertir
cortina : rideau
agua : eau
nieve : neige
repasar : vérifier, relire
enganar : mentir, tromper
demas : autre
invierno : hiver
sello : timbre
muneca : poupée
bastar : suffir, être suffisant 
otono : automne
sobre : enveloppe
arbol : arbre
primavera : printemps
discoteca : boîte de nuit, discothèque
rato : moment, instant
amar : aimer
reir : rire
panadero : boulanger
soltar : lâcher, jeter, détacher
hacienda : exploitation, propriété
comentar : raconter, expliquer, commenter
cacerola : casserole
desmayarse : s'évanouir