arruinar : ruiner
pozo sin fondo : puits sans fond
reubicar : déplacer, transférer
bolsillo : poche
honrar: honorer
paliza : raclée, branlée
contratacion : embauche
matadero : abattoir
fuente : source
declive : déclin
hecho polvo : crevé, épuisé
junta : assemblée, comité
cupula : coupole
complejo : complexe, compliqué
aliviar : soulager, calmer
aliento : souffle, haleine
abuchear : huer, siffler
ausencia : absence
quedarse sin blanca : se retrouver sans le sous
rematar : achever, couronner
meter la pata : faire une gaffe
bote : cagnotte, lot, prix
avispero : nid de guêpes
ambiente : environnement, entourage
trampa : piège
calentador : chauffe-eau
mojigato : prude, coincé
currante : travailleur
sacar : sortir, extraire, retirer
estropear : abîmer, esquinter
historial : antécédents
calabozo : cellule, cachot
el cazo : la casserole
patrullar : patrouiller
normative : règlementation
confundir : confondre
no es para tanto : ce n'est pas si grave
farsa : farce
broma : blague
adrenalina : adrénaline
fijar : fixer, accrocher
fingir : faire semblant
cabron : connard
joya : bijou
gasolinera : station-service, pompe à essence
en cuanto : dès que, aussitôt que
referirse : faire référence, se référer
en cuanto a : quant à
por supuesto : bien sûr, évidemment
pasada : passer
pasada : génial
cuartel : caserne
coloquial : parlé, familier 
cartel : affiche
rayar : au petit jour, aux premières lueurs du jour
inquilino : locataire
admitir : admettre
enchufar : brancher
cargar : charger
debajo : dessous, en dessous
celda : cellule
payaso : clown, guignol, pitre
acabar : finir, terminer
coger : prendre
juicio : procès
follar : baiser, niquer
remate : touche finale, fin
luchar : lutter, combattre
caminito : sentier, petit chemin
desgraciado : malheureux
enterrar : enterrer
papaito : petit papa
aro : anneau, cerceau
bautizo : baptême
bando : camp, côté
mejilla : joue
explotacion : exploitation
parto : accouchement
sed : soif
renegar : renier, désavouer
pandillero : membre d'un gang, voyou
cachondo : excité, chaud
maromo : amant, copain
hogar : intérieur, foyer
traidor : traître
traicionero : traître
cabana : cabane, hutte
alejar : éloigner
largarse : se tirer, se barrer
mantequilla : beurre
transitorio : transitoire
refrescar : rafraîchir
mosquita muerta : sainte-nitouche
mosquito : moustique
cesta : panier
nevera : réfrégirateur
microondas : four à micro-ondes
freidora : friteuse
cazuela : casserole
aunque : bien que
laboral : de travail, professionnel
despedir : licensier, congédier
recurrir a : faire appel à
un abrazo : bisous, je t'embrasse
retrato : photo
sumar : ajouter, additionner
ubicar : placer, mettre
oficina : bureau
solicitar : demander, solliciter
alquilar : louer
reto : défi
ocurrir : arriver, avoir lieu, survenir
asignatura : matière
aula : salle de classe
borrasca : tempête
verguenza : honte
delgado : mince, maigre
hipoteca : crédit immobilier
chiflado : cinglé, taré
desvelar : empêcher de dormir, maintenir éveillé
efusivo : démonstratif, expansif
morder : mordre
tampoco : non plus
conseguir : obtenir
respetar : respecter
inauguracion : inauguration
tiro : tir, coup de feu
chapero : gigolo
demonio : diable, démon
fiscalidad : fiscalité
impuesto : impôt, taxe
ambiente : air
medio ambiente : environnement
atmosfera : atmosphère
horno : four
estante : étagère
anaquel : étagère
mueble : meuble
mesa : table
silla : chaise
ventana : fenêtre
banera : baignoire
bano : toilette
aseo : toilette
talego : sac
cuarto de bano : salle de bain
plantearse : envisager, considérer
criminologia : criminologie
héroe : héros
obra : travaux
fundacion : fondation
mitad : milieu
coleta : queue de cheval
tantear : sonder, tâter
juerguista : fêtard
revista : revue
cajon : tiroir
cola : queue, file d'attente
planazo : coup de couteau
lio : être dans le pétrin
empujar : pousser
detector : détecteur
iluso : naîf, crédule
chiringuito : buvette, bar de plage
inquina : aversion
anoche : hier soir
arpia : femme vénale
flauta : flûte
flaco : maigre
convencer : convaincre
soldado : soldat
guerrero : guerrier
abrigo : manteau
temprano : tôt, de bonne heure
polvorin : poudrière
convivir : cohabiters
impune : impuni
lacra : fléau
solicitar : demander, solliciter
orgulloso : orgueilleux, fier
asumir : assumer
firmar : signer
legitima defensa : légitime défense
defensia propria : légitime défense
avispero : bourbier
palo : bâton
desposeimiento : dépossession
cesarea : césarienne
ingreso : entrée, admission
punetera : maudit, saleté de, fichu, satané, foutu
ausencia : absence
vengativo : vindicatif, rancunier
rencoroso : rancunier
defuncion : décès, mort
despistar : tromper, donner une fausse impression
difunto : décédé, défunt
manco : manchot
cobarde : lâche, peureux
escayola : plâtre
fiscal : inspecteur
ganga : aubaine
colocar : placer, poser, mettre
doubler : adelantar
aparcar : suspendre
sonar : sonner
collar : collier
pedalear : pédaler
aumentar la distencia : creuser l'écart
muslo : cuisse
pantorrilla : mollet
bajon : coup de mou, cafard
sombrero : chapeau
sena : indice, trace
cisne : cygne
sordo : sourd
ciego : aveugle
amuleto : amulette
cabecear : tanguer
rebaja : remise, réduction
baul : coffre, marre
lago : lac
retumbar : retentir
el pelo : les cheveux
penultimo : avant-dernier
ultimo : dernier
deslizar : glisser, faire glisser
moverse : mover
taponar : boucher
anhelar : désirer, aspirer à
aislamiento : isolement
camaleon : caméléon
fallecido : défunt, décédé
fallecer : décéder, mourrir
tramitar : faire les démarches
debilitar : affaiblir
parado : debout
bajo cuerda : sous le manteau
cachear : fouiller
cojonudo : super, dingue, terrible
acojonar : ficher la trouille
enganchar : accrocher, captiver
baja : arrêt de travail, congé maladie
amonestar : gronder, angueuler, réprimander
rango : rang
grabar : enregistrer, filmer
desempeno : bons résultats, bonnes notes
premio : prix, lot, prime
majara : fou, taré
cojin : coussin
edredon : couette
chulada : ventardise
rajarse : se dégonfler
punetero : casse-pieds
podrido : pourri, corrompu
remedio : solution
maletero : coffre, malle
corazonada : pressentiment, intuition
talego : taule, placard, gnouf
culpa : faute
remoto : lointain, reculé
moneda : pièces de monnaie
desencadenar : déclencher, provoquer
detapar : révéler
desvelar : dévoiler, revéler
sudadera : sweat-shirt
tumbar : mettre par terre, renverser
nublado : nuageux
pedo : beuverie, cuite
bobada : bêtise, sottise
coquetear : flirter, draguer
rebelde : rebelle
ilusionado : enthousiaste
alto al fuega : cessez-le-feu
lograr : réussir à, parvenir à
hacienda : fortune
pederasta : pédophile
renir : gronder, se disputer
falsedad : fausseté, mensonge
rebasar : dépasser
plusmarca : nouveau record
pantalla : écran
disfraz : déguisement
fiel : fidèle
contemplar : contempler
racha : rafale
colgante : pendentif
despistar : déconcentrer, distraire
ampliar : augmenter, agrandir
castigar : punir
investidura : investiture
rescatar : sauver
vencer : battre, vaincre
estatal : public, étatique
delito : délit, crime
aparcar : garer, stationner
descoordinacion : manque de coordination
asqueroso : dégoûtant, répugnant, déguelasse
sujetar : tenir, attacher, fixer
paliza : correction, raclée
molestar : déranger
bajon : chute, baisse
apuntar : noter, indiquer, montrer
apuntarse : s'inscrire, être partant
malla : collant
ingerido : démoralisé, découragé
engreido : prétentieux
enredadera : plante grimpante
emplear : employer, utiliser
estresado : stressé
birra : bière
desafiar : défier
arrancar : démarrer
revertir : restituer, revenir
apanarse : faire sa toilette, s'arranger
chucho : clébard, cabo
ahorrar : économiser
cachondear : se moquer de
prestamo : prêt
cadena : chaîne
fiscalia : parquet, bureau du procureur
una : ongle
logro : succès, réussite
herencia : héritage
emprendimiento : entreprise, entrepreneuriat
rebote : ricochet, rebond
morbo : curiosité malsaine, curiosité morbide
lacra : fléau
paradero : lieu, endroit
aduenarse de : s'emparer de
cabecilla : leader, meneur
acoger : accueillir, recevoir
rebano : troupeau
realeza : royauté, trône
chocho : gâteux, gaga
albergue : refuge, foyer
timar : escroquer, arnaquer
parado : être au chômage
derogar : abolir, abroger
patan : rustre, malotru, goujat
senado : sénat
retomar : reprendre
perjudicar : nuire à
mudarse : déménager
batido : milk-shake
acribillar : cribler de balles
ampliar : augmenter
balazo : coup de feu
pendiente : en suspens, en cours
anada : année
carabinero : douanier
sustraer : enlever, soustraire
fiscal : procureur
acopio : approvisionnement
forcejeo : lutte
rezagar : traîner, être à la traîne
censo : recensement
villano : mauvais, vil
entrada : entrée
cotilla : commère
ermitano : ermite
precavido : prévoyant
intuicion : intuition, pressentiment
carga : poids, fardeau
tapadera : couverture
despitarse : être distrait, se déconcentrer
atleta : athlète
policiaco : policier
embarcarse : embarquer, monter à bord
a rastras : a contrecoeur
cria : petit animal
atun : thon
entierro : enterrement
ataud : cercueil
floristeria : fleuriste
desnortar : désorienter
adentrarse : entrer dans, pénétrer dans
investigacion : enquête
acojonarse : avoir peur, avoir la trouille
sartén : poêle
alzada : appel, pourvoir
brazalete : bracelet
alcancia : tirelire
envidiar : jalouser, envier
bambino : gamin, enfant
guata : ventre, bide
vientre : ventre
estomago : estomac
troca : pick-up
hielo : glace, glaçon
carrito : chario, caddie
helado : glace
finura : finesse, délicatesse
anhelo : désir
andar : marcher
toma electrica : prise électrique
ternero : veau
becero : veau
pollo : poulet
cordon : lacet
acelerar : accélérer
aullar : hurler
cala : crique, calanque
cimientos : fondations
bombilla : ampoule (éclairage)
ampolla : ampoule (peau)
yema : jaune d'oeuf
pulgar : pouce
dedo grande : pouce (pied)
chupar : sucer, aspirer
vaso : verre (pour boire)
jarra : pichet
jarron : vase
lavadero : évier
cincel : burin
indice : sommaire, index
somera : sommaire, superficiel
barco : bateau
farol : lampadaire
banco : banc
sofa : canapé
tecla : touche (clavier)
teclado : clavier
costarle a alguien : avoir du mal
costar : coûter
neumatico : pneu
parabrisas : pare-brise
raiz : racine
lujo : abondance, excès
funda : taie d'oreiller, housse de couette
escritor : écrivain
pluma : stylo
dibujar : dessiner
homenaje : hommage
coro : choeur
rayo : rayon
campamento : campement
tarea : tâche, travail
temor : crainte, peur
estupefaciente : stupéfiant
orden : ordre
rumbo : direction
asentarse : se stabiliser, s'installer
mesero : serveur
desalentar : décourager
sidreria : cidrerie
fallido : raté, manqué
criar : élever
reptar : ramper
bachillerato : bac, baccalauréat
alborotador : perturbateur
sede : siège
nomina : paie, salaire
estafar : arnaquer, escroquer
cobrar : toucher, encaisser
despegue : lancement, commencement, démarrage
fabada : cassoulet asturien
resena : compte rendu, critique
aflorar : émerger
revés : revers, déception, déboire
matrimonio : mariage
relanzar : relancer
noticia : nouvelle
alarde : étalage, ostentation, exhibition
traspaso : prix de vente
guardaespaldas : garde du corps
escolta : garde du corps
franquisia : franchise
deslumbrar : éblouir
belleza : beauté
compromiso : accord
cortejar : courtiser, faire la cour
alardear : se vanter, fanfaronner
esposar : mettre les menottes
agraciado : gracieux, ravissant
estatura : taille
agradar : plaire, aimer, apprécier
convivencia : cohabitation
rentar : louer, mettre en location
alquiler : location
ira : colère, fureur, rage
gestacion : grossesse
altercado : altercation, dispute
destrozar : détruire
alboroto : tapage, vacarme, chahut
amanar : truquer
desmoronar : s'écrouler, s'effondrer
ahogar : étouffer, noyer
galpon : maison de plain-pied
socorro : secours
socorrista : secouriste, sauveteur
dantesco : dantesque
torso : torse
plato : assiette
plata : argent
fregar : laver, récurer
pulsera : bracelet
tireja : ciseau
escoplo : burin
esponja : éponge
florero : vase
banera : baignoire
cama : lit
pêche : melocoton
platano : banane
manzana : pomme
albaricoque : abricot
abrigo : manteau
chaqueta : veste
zapatilla : chausson
pantufla : pantoufle
zapato : chaussure
interuptor : interrupteur
bano : salle de bain, toilette
alfombra : tapis
esterilla : tapis, paillasson
pimienta : poivre
sel : sal
tetera : bouilloire
postre : dessert
canicula : canicule
jarabe : sirop
farmacia : pharmacie
cirujano : chirurgien
lavaplatos : lave-vaisselle
lavadora : lave-linge
tarjeta postal : carte postal
estatua : statue
armario : armoire
ropero : armoire, penderie
guardarropa : garde-robe
extremidad : extremité
hallazgo : découverte, trouvaille
forense : médico-légal
rociar : asperger, vaporiser, pulvériser
sustancia : substance
pesquisa : enquête, investigation
arrendar : louer
abanico : éventail
supermercado : supermarché
cotejo : confrontation, comparaison
certeza : certitude
sospechoso : suspect, louche
plagar : remplir de, couvrir de
venganza : vengeance
atormentar : torturer
deuda : dette
plantear : poser, exposer, envisager
esclarecer : élucider, clarifier
cerradura : serrure
apuntar : pointer, indiquer, montrer
paradero : être introuvable, être porté disparu
sicario : tueur à gages
culminar : achever
nave industrial : hangar, entrepôt
cadaver : cadabre
maleta : valise
guante : gant
ensanar : rendre furieux
colgante : pendentif
enseguida : tout de suite
coartada : alibi, excuse
rastrear : suivre à la trace, pister
recabar : récolter, récupérer
reciclar : recycler
queja : plainte, réclamation
deceso : décès
averiguacion : enquête, recherche
ubicarse : se trouver, se situer
sentir : sentir, ressentir
ojala : espéron
volcar : renverser
renuncia : démission
fango : boue
bulo : fausse information, rumeur
ahondar : creuser, approfondir
resquebrajar : fissurer, craqueler
murmullo : murmure
trascender : se propager, s'ébruiter
acallar : faire taire 
asesoramiento : conseil, assistance
desfasado : dépassé, vieux jeu
estigmatizar : stigmatiser
tasa : taux
crecimiento : croissance
paro : chômage
desbancar : déloger, détrôner
ciudadania : population
en vilo : dans l'attente, dans l'incertitude
vencedor : vainqueur
razonadamente : avec raison
encontrado : contradictoire
digusto : contrariété, colère
enmendarse : s'améliorer
verter : verser, déverser
entrelazar : entrelacer
acogida : accueil
flujo : flot
entrevistar : interviewer
destronar : détrôner
paradero : point de chute
rapar : raser, tondre
adelgazar : maigrir, mincir
fogon : fourneau
dependencia : pièce, agence
informal : peu sérieux, peu fiable
fianza : caution
esposar : épouser
sonar : rêver
estadio : stade
humildad : humilité
ascender : monter, gravir
escuadron : escadron
gasto : entretien (de la maison)
asesino a sueldo : tueur à gages
renacimiento : renaissance
culminar : culminer
carrera : course
retraido : réservé, renfermé
suspicaz : suspicieux, soupçonneux
debilidad : faiblesse
enriquecer : enrichir
redada : descente de police
adivinanza : devinette
pantera : panthère
ferreteria : quincaillerie
quemadura : brûlure
panuelo : mouchoir
noticia : annonce, avis
apanarse : se débrouiller
sudadera : sweat
rematar : couronner, achever
peleon : bagarreur
orgullo : fierté, orgueil
calvo : chauve
explotador : exploiteur, profiteur
precintar : fermer, sceller
redil : enclos
cocinero : cuisinier
acogedor : accueillant
perezoso : paresseux
escoba : balai, brosse
trapeador : serpillière
placa : plaque
tarjeta : carte
nieto : petit-fils
opinar : penser, donner son avis
telon : toile
mezcla : mélange
discurso : discours
ternura : tendresse
pecado : péché
comprobar : vérifier
traspié : faux-pas, trébucher
topetar : percuter
incautar : saisir, confisquer
chaleco antibalas : gilet pare-balles
chaleco salvavidas : gilet de sauvetage
atar : lier
soplon : mouchard, indicateur
caluroso : chaud
calabozo : cellule, cachot
afligido : triste, affligé
atormentar : tourmenter
autodesprecio : dégoût de soi
despreciar : mépriser, dédaigner
plagado : rempli, truffé
ensanarse : s'acharner
agotador : épuisant, exténuant, crevant
chorrada : bêtise, connerie
credencial : carte, accréditation
lastimar : blesser, faire mal
quejarse : se plaindre
lamentarse : se plaindre
compadecer : plaindre, avoir pitié
cotillear : raconter des potins, jaser
presunto : supposé, présumé
presumir : présumer, supposer
suponer : présumer, supposer
sintoma : symptôme
fijar : concentrer
agudo : aigu
averiguar : découvrir, trouver
emocionar : émouvoir
consentimiento : accord, consentement
yerno : gendre, beau-fils
uva : raisin
elegir : choisir
atender : être attentif, prêter attention
machacar : radoter, répéter, rabâcher
estrafalario : saugrenu
bofetada : gifle, claque
encajar : encaisser, imbriquer
amortiguar : amortir, atténuer
tajada : cuite
arrastrarse : ramper
la medicina : le médicament
medicacion : médicaments, traitement
desencadenamiento : déclenchement
realizar : réaliser
equivocarse : se tromper
trastorno : trouble
bula : bulle
crujir : craquer, crisser, grincer
pachucho : patraque, malade
polvora : colérique, avoir le sang chaud
oficio : métier
rellenar : remplir
cubo de la basura : poubelle
sombra : ombre
escopeta : fusil
metralleta : mitraillette
gaga : personne âgée gaga
plegaria : prière
gasto : dépense
carrito : poussette, landau
agobiar : déranger, incommoder
asustar : effrayer
cachas : musclé, bien foutu
establecer : établir
inversor : investisseur
escobar : balayer
banador : maillot de bain
cochino : cochon, porc, dégueulasse
remar : ramer
constancia : preuve, certitude
laguna : trou de mémoire
pillar : attraper, choper
vestido : robe
falda : jupe
despegue : décollage
engreirse : s'enorgueillir, prendre la grosse tête
camisa : chemise
zapato : chaussure
cordon : lacet
pintalabios : rouge à lèvres
pomada : pommade
peine : peigne
estragar : corrompre, pervertir
anillo : bague, anneau
gafas : lunettes
abridor : ouvre-boîte, ouvre-bouteille
reloj : montre
soplar : souffler
colarse : s'infilrer, s'incruster
partido : match
camiseta : t-shirt
capricho : caprice
caprichoso : capricieux
basca : bande de potes
regentar : diriger, tenir, être à la tête
crecida : crue
calderilla : petite monnaie
monedero : porte-monnaie
hucha : tirelire
table : planche
lealdad : loyauté
enarcar : froncer
desprender : détacher, décoller
compromiso : embarras, situation délicate
prestador : prêteur
acreedor : créditeur, créditeur
pego : tricherie, triche
traspasar : transférer, déplacer
transferir : transférer
verganza : vengeance
trasladar : déplacer, reporter
reformar : rénover, refaire
ligoteo : drague
ligarse a alguien : draguer, serrer
careto : visage, tronche, gueule
desatascar : débloquer, déboucher
traspaso : cession, transfert
ajuste : réglage, ajustement
flujo : flux
amargar : donner un goût amer, rendre amer
deudo : débiteur
arrasar : cartonner, faire un tabac
gabinete : gouvernement
al frente : à la tête
botin : butin
festejar : célébrer
timador : escroc
congeniar : sympathiser
corte : coupure, entaille, éraflure
parabrisas : pare-brise
arena : sable
periodo : règles
aunar : joindre, rassembler
aplastar : écraser, aplatir
rodar : tourner (un film)
destapado : découvert, révélé
sagrado : sacré
higuera : figuier
rodaje : tournage
en ayunas : à jeun
intercambiar : échanger
augurio : augure, présage
cobre : cuivre
sedimento : résidu
plata : argent (métal)
corretear : courir partout
empleado publico : fonctionnaire
jauria : meute
inusual : inhabituel
basta : ça suffit, assez
decada : décennie
tajar : trancher
tajada : part, morceau
leal : loyal
realeza : royauté
impune : impuni
deslegitimar : délégitimer
doblegar : dominer, vaincre
cinismo : cynisme
lograr : obtenir, remporter
intercambio : échange
rebajar : baisser, diminuer
rebaja : soldes
tregua : trêve
excarcelacion : libération
preso : prisonnier, détenu
cloro : chlore
comprometerse : s'engager à, promettre
refineria : raffinerie
negar : nier
mandar a la porra : envoyer se faire voir
aducir : invoquer, prétexter
suavizar : adoucir
pelele : pantin
derrota : défaite
suponer : supposer
existir : exister
compendio : résumé
almidon : amidon
atuendo : tenue, robe
monte : forêt, végétation
cetreria : fauconnerie
aperos : outils
la gaveta : le tiroir
apartado : éloigné, à l'écart
ceder : céder
costumbre : habitude
desbaratar : abîmer, esquinter
la pared : le mur
estruendo : vacarme
yeso : plâtre
montaraz : sauvage, champêtre
polvo : poudre
percance : contretemps, imprévu
a tientas : à tâtons
botiquin : armoire à pharmacie
hamaca : hamac
vejez : vieillesse
costado : côté
sien : tempe
alfareria : poterie
astilla : éclat
bautisterio : récipient en pierre
parpado : paupière
instinto : instinct
altaneria : fauconnerie
halcon : faucon
amaestrar : dresser, éduquer
buque : bateau, navire
fastos : fastes
espabilar : réveiller
actitud : attitude, comportement
sobra : excédent, en trop
migija : miette
afueras : banlieue, périphérie
discutir : se disputer
extrarradio : banlieue, périphérie
anicos : en mille morceaux, en miettes
remolino : tourbillon
horrendo : horrible, moche
enredar : emmêler, entremêler
martillo : marteau
turista : touriste
anhelo : désir, aspiration
roncar : ronfler
seso : cervelle, cerveau
cerebro : cerveau
lastre : obstacle, handicap
aplastamiento : écrasement
pellejo : peau
superar : oubier, passer à autre chose
coser : coudre
ternera : veau
manitas : bricoleur, bricoleuse
traidor : traitre
tarado : taré, dingue
portatil : portable, oridinateur portable
agacharse : se baisser, s'accroupir
tantear : sonder, tâter
sarten : poêle
la medicina : le médicament
verguenza : honte
presa : proie
amaestrar : éduquer, dresser
descuartizar : dépecer, démembrer
acezante : désireux
cerrero : rustre, obtus
tazon : grande tasse
estalliso : détonation, explosion
pisar : piétiner, écraser
cuchichear : chuchoter
lumbre : feu
achicar : pomper
sigiloso : discret
sorbo : gorgée
hornilla : plaque chauffante
destripar : étriper
montaraz : rude, rustre
glandula : glande
impetu : fougue
agarrar : attraper, saisir, prendre
desbravar : dompter, apprivoiser, adoucir
rafaga : rafale
humeante : fumant
tripa : intestin
entranas : entrailles
espanto : frayeur, effroi, horreur
inerme : sans défense
semejante : semblable
atrasar : retarder, ralentir
cebar : engraisser, gaver
amargar : gâcher, pourrir
bramido : mugissement, beuglement
estremecedor : bouleversant
buque de vapor : bateau à vapeur
tablon : grosse planche
techo : toit
cinc : zinc
gallinazo : vautour
cienaga : marécage
estuario : estuaire
caballeriza : écurie
aduana : douane
fachada : façade
camarote : cabine
machinaria : machines, engins
enredarse en : se mêler
alzada : hauteur
tranca : barre, bâton
muelle : quai
guirnalda : guirlande
mando : commandement
cruzar : croiser
rama : branche
detergente : lessive
ajedrez : échec
madera : bois
peon : pion
fastidiar : faire capoter, gâcher
machacar : blesser, faire mal
coronar : couronner
cuerno : corne
piedad : pitié
chungo : nul, pourri
respaldo : dossier (de chaise)
trapichear : magouiller, trafiquer
bocazas : bavard, pipelette
rastro : trace
guaperas : pin-up
panal : couche (bébé)
menudo plan : bon plan
estibador : docker
chusma : racaille
regodearse : se réjouir
redondo : rond
chisme : truc
amarrar : attacher
sermonear : sermonner, réprimander, faire la leçon, faire la morale
trena : taule, trou, placard, gnouf
procesar : poursuivre, intenter un procès
fontanero : plombier
pavo : type, mec
aburguesado : embourgeoisé
atajar : couper, prendre un raccourci
pava : meuf
arrebato : emportement, accès de folie
esconder : cacher
periodístico : journalistique
veraz : véridique, fidèle
senador : sénateur
parroquia : paroisse
albergue : hôtel, auberge
escalinata : perron
pila : pile
recargar : recharger
almacen : épicerie
manta : couverture
aceite : huile
frijol : haricot
rollo : rouleau
pasta de dientes : dentifrice
topar : percuter
criado : élevé
milagroso : miraculeux
desfavorecer : désavantager
saltar la valla : franchir la barrière
valla : clôture, palissade
funcionario : fonctionnaire
indio : indien
asumir : se faire à l'idée, admettre
pyme : PME
subsidio : aide, prestation, allocation
becaria : boursier
escudo : bouclier, protection
ala : aile
desahogarse : se défaire, se libérer
chunga : plaisanterie, farce
huerfano : orphelin
tragar : avaler
vacio : vide
bodega : cave
meditar : méditer, réfléchir à
estafador : escroc, arnaqueur
sotano : sous-sol
virtud : vertu
defecto : défaut
desarrollo : croissance, développement
deslumbrante : éblouissant
contrapuesto : opposé
marea : marée
exitoso : avoir du succès, prospère, florissant
apuro : problème, ennui
pecador : pécheur, pécheresse
pescador : pêcheur
rabo : queue, bite
interponer : interposer
impugnar : contester, faire appel
sujetador : soutien-gorge
vigilante : gardien
recluso : prisonnier, taulard
recluir : enfermer, placer en détention
algodon : coton
higiene : hygiène
reluciente : reluisant, brillant
bendecir : bénir
alejar : éloigner
reincidente : récidiviste
chivato : mouchard, délateur
celda : cellule
atascar : boucher
carniceria : boucherie
halcon : faucon
charcuteria : charcuterie
panaderia : boulangerie
desague : tuyau d'écoulement, évacuation
lamer : lécher
achicar : rétrécir
promedio : moyenne
jefe : chef, patron
regir : régir, gouverner, diriger
retraer : dissuader de faire quelque chose, se rétracter
taquilla : guichet
asado : rôti
matambre : paupiette
falda : hampe
ahogar : étouffer, asphyxier
vacio : tranche de boeuf
acopiar : accumuler
cepo : piège
pocilga : porcherie
criado : domestique
audaz : audacieux
inversion : inversion, permutation
chupete : tétine, tototte
chiquito : minuscule, tout petit
subvencion : subvention
hurtar : voler, dérober
prepotente : abusif, injuste
ajeno a algo : étranger à, extérieur à
entumecer : engourdir
opaco : opaque
vara : bâton
desplegar : déplier
adiestrar : entraîner, former
tienda : magasin, boutique
emboscada : embuscade, guet-apens
respaldo : sauvegarde (informatique)
soberania : souveraineté
estrechar : rapprocher, resserer, renforcer
lancha : cannot à moteur, zodiac
entumecido : engourdi
tienda de campana : tente, toile de tente
acampar : camper
campista : campeur
repunte : hausse
prevalecer : prospérer, perdurer, prévaloir
estacional : de saison 
sofocar : éteindre
desplazado : déplacé, réfugié
hoguera : bûcher
impedir : empêcher
reapertura : réouverture
endurecer : durcir
salvaje : sauvage
chivarse : cafter, moucharder
rebotar : rebondir
aviso : avertissement
punalada : coup de couteau
escalofriante : effrayant, terrifiant
fregona : serpillière
humo : fumée
ambiante libre de humo : espace non-fumeur
disfraz : déguisement
helado : gelé
camilla : brancard, civière
avaricia : avarice
silueta : silhouette
escombros : décombres, débris
pringado : pauvre type, couillon
flechazo : tir de flèche
regordete : rondelet, grassouillet
revolcon : baise, partie de jambes en l'air
corredor : courtier
tapado : caché
escote : décolleté
meramente : simplement, seulement
encajar : coïncider, concorder
padrino : parrain
cortar con : rompre avec, casser avec
dar media vuelta : faire demi-tour
permiso : permission, congé
mentira : mensonge
burgués : bourgeois
respaldo : soutien, appui
destapar : révéler
ofrenda : offrande
lentilla : lentille (yeux)
buzon : boîte aux lettres
repasar : réviser
reloj : montre
pillar : surprendre
alcaide : directeur de prison
presa : prisonnière, détenue
discurrir : réfléchir, raisonner
despistado : distrait
chupa : veste
prescindible : superflu
rescindible : résiliable
bambino : enfant
estaca : pieu, gourdin
raton : souris
risueno : souriant, avenant
proveedor : fournisseur
bendecir : souhaiter bonne chance
rajarse : se casser
sobremanera : terriblement, extrêmement, excessivement
auriculares : écouteur
taburete : tabouret
tendedero : étendoir
en vilo : dans l'attente, dans l'incertitude
expectacion : attente
pesimismo : pessimisme
senal : indication
firmemente : fermement
socavar : saper
subalterno : subalterne
dependiente : dépendant
juzgado : tribunal
aforo : capacité
desfallecer : s'évanouir, tomber
auditorio : auditorium
llamamiento : appel, convocation
caceria : chasse
lodazal : bourbier
lema : devise, slogan
conformarse : se contenter de
conformar : donner forme, se définir
palmera : palmier
escalofrio : frisson, chair de poule
acero : acier
ilusion : rêve, espoir, désir
adobar : faire mariner
zapatero : cordonnier
herrero : forgeron
fuera de juego : hors-jeu
saque : touche
taberna : bar, café, bistrot, taverne
alfarero : potier
escombrera : déchetterie, décharge
prejuicio : préjugé
adobar : tanner
madero : tronc, bois
cantaro : cruche, carafe
cestero : vannier, fabricant de panniers
informal : informel, décontracté
flequillo : frange
agur : au revoir
flechazo : coup de foudre
fase : phase, étape
infalible : infaillible
perjuicio : préjudice, tort
buho : hibou
brindar : lever son verre, trinquer
oso : ours
ciervo : cerf
liebre : lièvre
barba : barbe
bigote : moustache
pestana : cil
parpado : paupière
lenteja : lentille (aliment)
rimel : mascara
fortaleza : forteresse
oreja : oreille
diente : dent
hormiga : fourmi
bala : balle
disolver : dissoudre
descarte : défausse
violencia : violence
nariz : nez
retorica : rhétorique
traje : tenue, vêtement
terno : costume
voto : vote
pasmar : surprendre
asombrar : impressionner, émerveiller
desagradar : déplaire, contrarier
granja : ferme
rana : grenouille
aclarar : éclaircir, lever un doute
dibujar : dessiner
disenar : concevoir
maniobra : manoeuvre
machinaria : mécanisme
dimitir : démissionner
al reves de : contrairement à
comparecencia : comparution
cuello de botella : goulot d'étranglement
premiar : récompenser
demora : retard, délai
alza : hausse, augmentation
soborno : corruption
pulso : bras de fer
corredor de apuestas : bookmaker
tintar : teindre, colorer
reanudar : reprendre, continuer
esofago : oesophage
guadana : faux (outil)
paradero : endroit, lieu
ciudadania : citoyenneté
espiar : épier, espionner
discurrir : s'écouler (temps)
eleccion : choix
acogida : accueil
zorro : renard
topo : taupe
galardon : prix, récompense
bienestar : bien-être
aumenter : augmenter
encarecer : augmenter (prix)
amparo : protection
enfoque : point de vue
librarse : échapper à, se débarraser de
erosionar : éroder
librar : préserver, protéger
lastrar : plomber, compromettre
sujetarse a : se soumettre à
alistar : lister, inscrire sur une liste
descarillar : dérailler
desvincular : rompre, mettre un terme, arrêter
ligar : attacher, nouer
atar : lier
temer : craindre, avoir peur
judio : juif
desalentador : décourageant, démoralisant
llanto : pleurs, larmes
rogar : implorer, demander
tregua : trêve
fracaso : échec
disparado : pressé, en coup de vent
subgenero : sous-genre
elogiar : faire l'éloge
goteo : afflux
estadounidense : américain, états-unien
umbral : seuil
enfrentado : opposé, adverse
enfrentar : affronter
accarear : provoquer, amener, entraîner
abrumador : accablant
arruinar : ruiner
flotar : flotter
suministrador : fournisseur
afianzar : fixer, accrocher
trotamundos : globe-trotteur
propenso : qui a tendance à
media : moyenne
chufa : médiocre, pourri
machete : avare, radin
eufemismo : euphémisme
insostenible : insoutenable
ganadero : de l'élevage
despoblado : dépeuplé
florear : fleurer
horroroso : horrible, atroce
labrar : cultiver
escasamente : rarement
envejecido : vieilli
cargo : charge, responsabilité
salvajada : folie, connerie
portal : portail
hundido : englouti, immergé
cierre : fermeture, coupure
invertir : inverser
rendir : donner des résultats, être performant
platicar : discuter, bavarder
rotundamente : catégoriquement
cavar : creuser
extrano : bizarre, étrange
desgarrador : déchirant, poignant
atender : recevoir, accueillir
machona : garçon manqué
sobre todo : surtout, principalement
salvaje : sauvage
asalariado : salarié
asaltar : attaquer, agresser, assaillir
ineludible : incontournable
verdugo : bourreau
lodazal : bourbier
tropa : troupe
revistar : passer en revue, inspecter
juramento : serment
sobrevolar : survoler
transcurrir : s'écouler, passer
campamento : camping
exito : réussite
roca : roche
alunizar : alunir (atterir sur la Lune)
resentirse : s'offenser, en vouloir à
recursos : ressources
ensayar : tester
aviso : notification
vincular : lier, unir
costumbre : coutume, habitude
titular : gros titres
temporal : tempête, orage
azotar : battre, fouetter
apoderar : déléguer, mandater, donner procuration
odio : haine
cruce : passage piétons
cruzar : traverser
presionar : faire pression sur
discutir : discuter
urgir : urger
desavenencia : désaccord
burgues : bourgeois
sorna : sarcasme, ironie
rostro : visage, face
abucheos : huées
teorico : théoricien
comprometido : engagé
pabellon : pavillon
bombardeo : bombardement
regodearse : se complaire
cazador : chasseur
lienzo : toile
oleo : huile
comprometerse : compromettre, impliquer
acontecimiento : évènement, fait
desolador : désolant, navrant
placentero : plaisant, agréable
marfil : ivoire
entresacar : tirer, extraire
mural : fresque, peinture murale
campesino : paysan
igualidad de genero : égalité hommes femmes
poseer : posséder
campo : champ
semilla : graine, semance
autoridad : autorité
palo : bâton
tapadera : couverture
amparar : protéger
infravalorar : sous-estimer
bondad : bonté
decalogo : règlement
brecha : fossé, distance
desmenuzar : examiner, disséquer
vuelco : retournement, renversement
pesquisa : enquête, investigation
puerto : port
inequivoco : clair, sans équivoque
embestida : assaut, attaque
arremeter contra : se jeter sur, s'en prendre à
distinto : différent
remitir : envoyer, expédier
reja : grille, barreaux (prison)
criterio : opinion, avis
preaviso : préavis
al raso : à la belle étoile
custodiar : protéger
bursatil : boursier
apercibimiento : avertissement
agradar : aimer, plaire, aprécier
farmaco : médicament
beca : bourse
patera : embarcation de fortune
prenda : vêtement
naranja : orange
descartarse : se défausser
cargo : charge, accusation
tripulante : membre de l'équipage
mando : tableau de bord
casco : coque
vetar : interdire, prohiber
mezquita : mosquée
suministrar : fournir, approvisionner
cercania : proximité
blindado : protégé
atentado : attentat
agudo : vif
lema : slogan, devise
estrado : barre, salle d'audience
enquistar : incruster
acuchillar : poignarder
absolver : acquitter, absoudre
altercado : altercation
abuchear : huer, siffler
envejecer : vieillir
cucaracha : cafard
desencuentro : désaccord, discorde
torno : tour
amenazar : menacer
superar : surpasser, dépasser
barullo : désordre, bazar
extremar : renforcer
tachar de : taxer de, accuser de
soborno : corruption
antiabortista : anti-avortement, anti-ivg
incidir en : influencer
presupuesto : budget, devis
atajar : contenir, stopper
sumo : suprême
rosario : chapelet
saciar : satisfaire, assouvir
grano : grain
feretro : cercueil
cortejar : courtiser
ensalzar : élever, ériger, offrir une promotion
arrojar : donner, aboutir à, se solder par
aplastante : dévastateur, écrasant
traspasar : déplacer, transférer
matricula de honor : félicitations du jury
asquear : dégoûter, répugner
ferrocarril : train, chemin de fer
peldano : marche (escalier)
escalera : escale
via ferrea : voie ferrée
patrullaje : patrouille
ensayo : test, essai
paracadista : parachutiste
cruce : croisement
soborno : pot-de-vin
comicios : élections
rembolsar : rembourser
arropar : couvrir, envelopper, emmitoufler
perjurio : parjure
visto bueno : accord, approbation
aprobacion : approbation, autorisation, accord
aplauso : applaudissement
convalidacion : validation
indultar : gracier
pleno : séance plénière
llamar al orden : rappeler à l'ordre
ensordecedor : assourdissant
armatoste : objet encombrant
sudadera : sweat-shirt
soleado : ensoleillé
hervidero : fourmillement, fourmilière
lentejuela : paillette
guino : clin d'oeil
pantomima : farce
liderar : diriger, mener
tapadera : couverture
tramitacion : gestion, conduite, démarche, procédure
mascarilla : masque
secuela : séquelle
macho : mâle
cosecha : récolte
abalanzarse : se jeter, se ruer
asegurar : certifier, assurer, garantir
arrojar : démontrer, mettre en évidence
premiar : récompenser, décerner un prix
demoler : démolir
apear : faire descendre
atadura : liens, attache
magnitud : ampleur, étendue, importance
anillo : périphérique, rocade
albergar : abriter, accueillir, héberger
registro : registre
colapsar : paralyser, bloquer
entranas : entrailles
senal : indication
extraviar : perdre, égarer
escalinata : perron
remozar : rajeunir
entorno : environnement
legado : héritage
repleto : plein, bondé
bando : camp, côté
despajar : dégager, débarrasser
aquejar : affliger
tanda : série, séance
cuajar : prendre forme, se concrétiser
guinda del pastel : cerise sur le gâteau
intuir : pressentir
jejatera : direction
nombre de pila : nom de baptême
peyorativo : péjoratif
liderazgo : leadership
respaldar : épauler, soutenir
espalda : dos
hombro : épaule
agrupacion : regroupement
destierro : exil
vencer : vaincre
soberania : souveraineté
valedor : protecteur, gardien
interina : intérimaire, vacataire
surena : du sud
temporero : intérimaire
almendra : amande
recoleccion : cueillette, récolte
tercero : tiers
recelo : suspicion, méfiance
subsidio : aide, prestation, allocation
barbecho : jachère
presupuesto : budget, devis
encuesta : sondage
encabezar : être à la tête de
en torno de : aux alentours de
mandatario : chef d'état, dirigeant
competir con : rivaliser avec
gozar de algo : profiter de
apuesta : pari
amargo : aigri
contrincante : adversaire
toma : prise
al frente de : à la tête de
arrojar : jeter, lancer
escrutinio : dépouillement du scrutin
mayor : plus grand
manejar : manipuler
cebra : zèbre
efectivo : efficace
enfoque : approche
alzarse : s'emparer
registro : fouille, perquisition
recua : bêtes de charge
apostar por : miser sur
herencia : héritage
resaltar : se démarquer, resortir
gozar de algo : jouir de, bénéficier de
imperar : régner, dominer
ambito : domaine, secteur, milieu
centenar : centaine
llevar a cabo : mener à bien
enquitarse : se paralyser
fortalecimiento : renforcement
equidad : équité
cargo : poste, fonction
jefatura : direction
contienda electoral : campagne électorale
contender : lutter, se battre
semilla : graine, semence
estelar : magnifique, splendide, prestigieux
tender lazos : tisser des liens
achacar : attribuer à, imputer à
contienda : dispute, conflit
abogar : plaider, défendre, soutenir
granjear : attirer
melocoton : pêche
selva : jungle, forêt tropicale
instar : prier, implorer
escurrir : sécher, égoutter, essuyer
acoger : accepter, recevoir
carrera : carrière
gabinete : gouvernement
logro : succès, réussite
destacar : souligner, mettre l'accent sur
aglutinar : rassembler
atadura : astreinte, entrave
impedimento : empêchement, obstacle
impune : impuni
gasto publico : dépenses publiques
recaudar : récolter, collecter
senda : sentier, chemin
sexenio : sextennat
tender puentes : bâtir un pont
choque : affrontement, bagarre, accrochage
robo con allanamiento : cambriolage
prender : attacher, accrocher
allanamiento : effraction, violation de domicile
creible : crédible
conteo : dépouillement
apuntarse : s'inscrire
puntualizar : préciser, spécifier
penultimo : avant-dernier
comprometerse : s'engager, promettre
atajar : contenir, stopper
padrino : parrain
diario : journal intime
mediante : grâce à, moyennant, à l'aide de
vaticinar : prédire
marcado : fort, prononcé, accuentué
galo : français, gaulois
desvincular : rompre, mettre un terme, arrêter
prorroga : prolongation
astro : star
recorte : réduction, coupe budgétaire
terminos interanuales : glissement annuel
previo a : antérieur à
estacional : de saison
registro : enregistrement, inscription
precariedad : précarité
valorar : estimer, expertiser
trabajador autonomo : travailleur indépendant
cuenta propia : à leur compte
colocar : placer, poser, mettre
por encima de : au-dessus de
contratacion : embauche
asimismo : de même, de la même manière
afiliacion : adhésion
suceso : évènement, fait
invernadero : serre
ansioso : nerveux, anxieux
en torno a : autour de
retén : équipe, brigade
nucleo : noyau
levantamiento : soulèvement
actuacion : conduite, façon d'agir
comparecencia : séance de presse
casero : artisanal, rudimentaire
luto : deuil
buceo : fouiller, se plonger
oso : ours
melocotonero : pêcher
padecer : souffrir, être atteint
tozudo : têtu, obstiné, borné
forjar : forger
vinculo : lien, relation
mordaz : mordant, cinglant
travieso : espiègle, coquin, malicieux, polisson
irrumpir : faire irruption, débarquer
abanderar : jouer un rôle moteur
alegato : plaidoyer
mito : mythe
involucrar : impliquer
chivo : promotion
becerro : veau
expiato : bouc émissaire
latiazo : coup
leve : léger
tropezar : trébucher
comicios : élections
vincular : lier, unir
vigente : en vigueur
cautelar : préventif
tramitar : faire les démarches
consta : être inscrit, figurer
estrecho : serré, étroit
sopesar : examiner, peser le pour et le contre
cayuco : pirogue
matanza : tuerie, massacre
sesgado : biaisé
madrina : marraine
bullicio : agitation, animation
sesgar : couper en biais, tordre
folleto : brochure, prospectus, tract
plovo : poussière
librar de : préserver, protéger
cauce : lit (eau), canal
gotera : fuite
vulgar : banal
listillo : petit malin
tasa : taxe, impôt
en jaque : en échec
deslizarse : se glisser, se faufiler, s'introduire
turbio : trouble, louche
genio : génie
echizo : charme, envoûtement
sacerdote : prêtre, curé
plaga : fléau
capo : parrain (chef mafieux)
granja : ferme
graduarse : obtenir son diplôme
legumbre : légume
acostar : coucher, allonger
convicto : détenu, prisonnier
cautiverio : captivité
calzar : chausser
carpintero : menuisier, charpentier
oporto : porto
desvelarse : ne pas trouver le sommeil
conmocionado : bouleversé, touché
apoderar : déléguer, mandater, transmettre
apoderarse de alguien : s'emparer de qqn
largometraje : long-métrage
sabotear : saboter
desatar : déclencher, entraîner
cesar : cesser
arremeter contra : se jeter sur, foncer sur
nombramiento : nomination
reprobar : réprouver, condamner
subsidio : aide, prestation
tumbar : renverser, mettre par terre
reanudar : continuer, reprendre
tachar de : taxer de, accuser de
anegar : inonder
prejuicio : préjudice
desencadenar : déclencher, entraîner, provoquer
desmoronarse : s'écrouler, s'effondrer
improperio : insulte
extorsionar : escroquer, voler, extorquer
patinar : patiner
desatar : détacher
hilo : fil
mover los hilos : tirer les ficelles
arrodillarse : s'agenouiller
yacer : gésir
columpio : balançoire
escurrirse : filer, passer à toute vitesse
oreja : oreille
temblorose : tremblant
con lo cual : c'est pourquoi, par conséquent
despistar : induire en erreur, donner une fausse impression
virgueria : merveille, chef d'oeuvre
hacinarse : s'entasser
jurado : juré
bazofia : daube, bouse
empenarse en : s'obstiner
debil : fragile, faible
tabarra : désagrément, embêtement
sandez : bêtise, sottise
superdotado : surdoué
costura : couture
inconveniento : inconvénient
designar : désigner
fichaje : recrutement
estrenar : donner la première de
abarrotar : remplir
ingenieria : ingénierie
roto : cassé, brisé
quebrar : casser, briser
cascar : frapper, briser
congregar : réunir, rassembler
gruta : grotte
sàbana : drap
defraudar : décevoir
retiro : retrait
ola : vague
salvajemente : sauvagement
imprescindible : indispensable, obligatoire
percibir : percevoir, remarquer
pegar : coler
pecado : péché
bollera : gouine, lesbienne
coloquio : discussion, débat
forense : médecin légiste
lidia : combat, lutte
senalar : montrer du doigt, désigner
dolido : blessé
concejal : conseiller municipal
averiguar : découvrir, trouver, chercher à comprendre
juzgar : juger
amargar : gâcher, empoisonner
ocultar : cacher, dissimuler
resecar : dessécher
arrepentir : regretter
agujero : trou
hormiga : fourmi
apoderar : s'emparer, envahir
transcender : faire connaissance
mendigar : mendier, quémander
recalcar : insister sur, souligner
ingresar : admettre, intégrer
arropar : soutenir, supporter
apartar : pousser, écarter, déplacer
arrullar : bercer
hembra : femelle
yedra : lierre
coletero : élastique, chouchou
disfrazar : déguiser
cauto : prudent
incauto : imprudent
ingeniudad : innocence, naïveté, ingénuité
burbujear : faire des bulles, pétiller
morado : violet
enmendar : corriger, réparer, amender
subsanar : pallier
atronador : assourdissant
canciller : chancelier
abucheo : huée
ingeniero : ingénieur
gabinete : cabinet, bureau
achicar : reculer, fuir
canjear : échanger (personnes, choses)
encuesta : enquête, sondage
enfurecer : rendre furieux
armadura : armature
indomito : indomptable
moho : rouille
ensayo : essai (littérature)
reblandecer : ramolir
caldera : chaudière
loco de remate : fou à lier
arrebatar algo a alguien : confisquer
estreno : lancement, première
conmocionar : bouleverser
salvamento : sauvetage, secours
tortuoso : tortueux
aterrador : terrifiant, effrayant
desahogarse : se libérer, se défaire, se débarrasser
pauta : règle, norme, critère
paisa : compatriote, du même pays, de la même région
gafe : porter la poisse, poissard
faena : mauvais tour
resuelto : résolu
cierre : fermeture éclair
atras : en arrière, vers l'arrière
atasco : obstacle, entrave
laguna : lacune
cruz : pile
cara : face
suministro : approvisionnement, distribution
fiambre : macchabée, cadavre
beneficio : bénéfice
jodido : niqué, foutu, fichu
cacheo : fouille
consigo : avec soi
adorno : décoration
tela : toile, tissu
consejeria : ministère
maltrecho : mal en point
embustero : menteur
ansiar : souhaiter profondément, avoir très envie de
escurrir : couler
chuleta : antisèche
cenir : marquer, mouler, être cintré
escolta : garde du corps
ondear : ondoyer, ajouter
llaga : plaie
lince : lynx
cachorro : chiot
atropello : collision, accident
barriga : ventre, bedaine
pantano : marécage, marais
orilla : bord, rive, berge
embalse : bassin de retenue, lac artificiel, barrage
termas : thermes (bassin chaud)
arenoso : sableux, sablonneux
apartar : exclure, tenir à l'écart
manantial : source
chorro : jet (eau)
humear : fumer
rencilla : querelle
foraneo : étranger
poza : mare
templar : tempérer, calmer
papada : double menton
incauto : naïf
manchar : tâcher
transcender : se propager, s'ébruiter
ajetreo : agitation, effervescence
relucir : briller, étinceler
verde : jeune, inexpérimenté, immature
enésimo : énième
velero : voilier
pantomima : farce
torcer : tourner, tordre
maleza : broussaille
balsa : radeau
amoratar : violacer
espuma : écume, mousse
rasgos : traits, physionomie
hinchazon : bosse, gonflement
enmaranar : emmêler
tragar : avaler, dévorer
subyugar : subjuguer
sujetar : tenir, attacher, fixer
intrascendente : insignifiant
benemerita : guarde civile, gendarmerie
lancha : canot à moteur
cabo : brigadier, caporal
espantoso : horrible, terrifiant
desprenderse : se débarraser
fingido : feint
torpe : maladroit
tararear : fredonner, chantonner
surtir efector : faire effet
seriedad : sérieux
braga : culotte, slip
arrancar : arracher, enlever
eludir : esquiver, éviter
aborto : avortement
pasmoso : ahurissant, stupéfiant
computo : calcul, compte
oposicion : concours
baja : arrêt de travail
desaliento : découragement
enganchar : accrocher, captiver
hastiar : fatiguer, lasser, excéder
agrado : goût
pluralizar : généraliser
asomar : sortir, montrer
trago : coup dur
niebla : brouillard, brume
embutido : charcuterie
jalear : exciter
suegro : beau-père
embate : coup, assaut, bourrasque
pina : clan, groupe uni, groupe soudé
sumir : enfoncer, plonger, sombrer
negrura : noirceur, obscurité
mentalizar : faire prendre conscience
radicar : se trouver, résider
cachorro : chiot
jaleo : foin, histoire, scandale
intuir : pressentir
rayos : incroyable, magnifique
peludo : poilu, velu
derretir : faire fondre
cursi : cucul, gnangnan, à l'eau de rose
ablandar : ramollir, amadouer
caricia : caresse
barullo : vacarme, tapage, boucan
meta : but, objectif
logro : succès, réussite, victoire
inconcebible : inconcevable
desmedido : démesuré
danzar : danser
grunir : grogner
lastimosamente : déplorablement, de façon regrettable
morrina : mal du pays
desmontar : démonter
cortina de hierro : rideau de fer
sensato : sensé, sage, prudent
regatear : négocier, marchander
en un pis pas : en un instant, en un clin d'oeil
cuanto antes : dès que possible
quitar de encima : débarrasser de qch
rapto : accès
parlotear : bavarder, jacasser
colar : s'infiltrer
chollo : bonne affaire, aubaine
pijo : bourgeois
rebatir : réfuter, rejeter
bodorrio : mariage de débauche
prendar : plaire, charmer
panfilo : idiot, niais
salvaguardar : protéger
entero : digne
enloquecer : exaspérer, rendre fou
desconsuelo : tristesse, chagrin
pairo : arrêt
mustio : morose, triste
engano : tromperie, mensonge
hacer el papelon : se donner en spectacle, se tourner en ridicule
forestal : forestier
pasto : herbe, pâturage
matorral : fourré, brousse
nucleo urbano : noyau urbain
sobrar : rester
chiste : blague
bochorno : canicule
tramo : portion, tronçon
empedrar : remplir, couvrir
requisito : condition requise, prérequis
carraspear : toussoter, se racler la gorge
mofar : se moquer de
resfriado : rhume, enrhumé
jalear : encourager, acclamer
mediado : à moitié
exhaustivo : exhaustif
dar de lleno : taper dans le mille
atento : attentif
ampararse : se servir, invoquer
ahogamiento : noyaude
paga : paie, paye
golear : écraser, marquer de nombreux buts
en cuanto a : concernant, pour ce qui est de
destartalado : délabré, détérioré, vétuste
taquilla : casier
chancla : tong, claquette, sandale
subidon : montée
engullir : engloutir
prenda : vêtement
vaquero : jean
dilacion : délai, retard
pestillo : verrou
polvo : poudre
enrollar : enrouler
raya : ligne, trait
juicio : jugement
sudario : linceul
esnifar : sniffer
cima : sommet, cime
pantalon corto : bermuda
toparse con : rencontrer, tomber sur
tirillas : sac d'os
acrecentar : accroître, augmenter
fatuidad : sottise, bêtise
tupé : banane (coupe de cheveux)
laca : laque
espuma : mousse de coiffage
chaval : gamin
peinado : coupe de cheveux
rapar : raser, tondre
lata : boîte de conserve
esparadrapo : sparadrap
antagonico : antagonique, opposé
pudoroso : pudique
ajeno a : étranger à
frialdad : froideur
asomar : apparaître, poindre
ira : colère, fureur, rage
rondar : tourner autour de, rôder autour de
calzoncillos : caleçon, slip
gastado : usé, délavé
goma : élastique
percatarse de algo : se rendre compte de
aranar : égratigner, érafler
lleno : plein
paralitico : personne atteinte de paralysie
bromear : blaguer, plaisanter
paleto : plouc
fofo : mou, flasque
peludo : poilu
pegar un tiro : se tirer une balle
desprecio : mépris
enjabonar : savonner
no caber duda : sans aucun doute
loncha : tranche
dedo corazon : majeur
advertencia : avertissement
patinar : gaffer
entereza : force de caractère
pinza : pince à linge
ufano : fier, orgueilleux
zanjar : régler, résoudre
ensanamiento : méchanceté
gallito : petite terreur, petit chef
vaho : buée
gélido : glacé, gelé
molino : moulin
planta baja : rez-de-chaussée
ensueno : rêve
voy tirando : j'arrive à m'en sortir
bastante : assez
bollo : petit pain, viennoiserie
empeno : tenacité, persévérance
engano : aveuglement, illusion
ocurrencia : idée soudaine, fulgurance
pasado manana : après-demain
rendija : fente
colar : glisser, s'introduire
collar : collier, laisse
gemido : gémissement
estornudar : éternuer
letargo : léthargie
mermar : réduire, diminuer
sin estrenar : tout neuf, flambant neuf
escandalo : scandale
partir : découper, diviser
embriagador : enivrant
aun : encore
espeso : épais
faro : phare
bombilla : ampoule
paso de cebra : passage piétons
embestir : charger, attaquer
atropellar : renverser, faucher, écraser
ojera : cerne
acuoso : mouillé, humide
enrojecer : rougir
hechizar : ensorceler, envoûter
mandil : tablier
paisano : compatriote
colmar : combler, satisfaire
acodarse : s'accouder
barra : bar, comptoir
desperdigado : dispersé, éparpillé
puesta de sol : coucher du soleil
dardo : fléchette
acertar : atteindre, mettre dans le mille
diana : cible
cierva : biche
trigo : blé
orondo : gros, gras
presteza : rapidité
envergadura : envergure, importance
pillar : surprendre, attraper
casero : casanier
cazar : prendre sur le vif
desempenar : réaliser, mener à bien
tanatorio : funérarium
bodega : soute (avion)
palo : bâton
comarca : canton
bocado : bout, morceau
calido : chaleureux
toque : touche, pointe
acristalado : vitré
hierro : fer
auto : ordonnance, jugement, décision
estrepitoso : retentissant, fracassant
auxilio : à l'aide, au secours
preso : prisonnier
azufre : souffre
bullicio : brouhaha, bruit
hastiar : fatiguer, lasser
clavar : planter, enfoncer
desdenable : négligeable
amarillento : jaunâtre
sereno : tranquille, calme
reprimir : réprimer, contenir
ronco : enroué
tufillo : mauvaise odeur, puanteur
taponar : boucher
lingotazo : gorgée
melena : chevelure
bachillerato : lycée
cotizado : courtisé
enrollarse : trop parlé, s'éterniser
claustro : corps enseignant
de reojo : du coin de l'oeil
premura : urgence
hondo : profond
procesar : traiter, transformer
rastro : trace
osadia : audace, témérité
convento : couvent
clausura : clôture
rabiar : enrager
indole : caractère
currar : bosser, taffer
carpeta : chemise, dossier
asaltar : se poser la question
regular : moyen
despistar : déconcerter, distraire, dérouter
mentalizado : préparé mentalement
atenerse : s'en tenir
al tanto : au courant
comecome : démangeaison
arrepentirse : se rétracter
destino : destination
descolocar : déplacer
escueto : simple, succinct
firme : décidé, sûr, déterminé
pito : sifflet, klaxon
dilatar : dilater
temario : programme
casilla : case, casier
deje : accent
birria : daube, merde
candorose : candide
enternecer : attendrir, émouvoir
suelta : lâche, détendu
alabar : louer, vanter, faire l'éloge de
molar : être super, être génial
rehuir : fuir, éviter
mediar : intervenir, servir de médiateur
empantanado : marécageux
dotar : faire
tragar : avaler, dévorer
abismo : précipice, abîme
acechar : guetter, traquer, être à l'affut de
aferrarse a : s'accrocher à
curandero : guérisseur
avispa : guêpe
bocajarro : à bout portant
cenido : cintré, moulant
retar : défier
torpe : bête, niais, nul
pizarra : ardoise, tableau
surtir : jaillir
tapujo : cachotterie, secret
germen : germe
chupinazo : tir
demoledor : destructeur, dévastateur
negar en redondo : nier en bloc
cuervo : corbeau
revolotear : voleter
cola : queue (animal)
alarde : étalage
sin cesar : sans cesse
plaga : invasion, infestation
perdirle peras al olmo : demander l'impossible, demander la lune
casero : propriétaire
enjuto : sec, maigre
arrugado : ridé
salton : globuleux
empenarse : s'endetter
griferia : robinetterie
cenefa : plinthe, frise
azulejo : carreau
pulido : polissage
hinchable : gonflable
tampoco es para tanto : ce n'est pas si grave
sabiamente : intelligemment, sagement
categratico : professeur d'université
jabali : sanglier
toparse : se croiser
cabezon : têtu, entêté
arramblar : rafler (avec violence)
gilipollez : connerie
gamberro : voyou, vandale
rejuvenecer : rajeunir, rafraîchir
delantal : tablier
tremebundo : épouvantable
pregonar : proclamer, rendre public
enclaustrat : cloîtrer, enfermer
halago : compliment, éloge
acertar : deviner, trouver
de puntillas : sur la pointe des pieds
sonrosado : rosé
suduroso : en sueur
rodaballo : turbot
razon : raison, cause, motif
consulta : cabinet médical
pista : piste, trace
prodigarse : se montrer
efusivo : démonstratif, expansif
mimar : cojoler, choyer
chantajear : faire du chantage à
beneplacito : consentement, approbation
cunado : beau-frère
sobrino : neveu
encaramarse : se hisser, grimper
guarrada : cochonnerie
manantial : source
traer al pairo : s'en ficher, s'en moquer
echar las campanas al vuelo : crier sur les toits
ombligo : nombril
dechado : modèle
faccion : traits
invernadero : serre
huerta : potager, verger
cebolla : oignon
tropelia : abus
frenetico : furieux, hystérique
soler : avoir l'habitude, être habitué à
percatarse de algo : se rendre compte de
achispar : saouler
esporadico : sporadique
cucharilla : petite cuillère
expectante : dans l'attente
derrotero : chemin, voie
atragantarse : s'étouffer
semblante : visage, mine
trago : gorgée
fuera de onda : à côté de la plaque
contundencia : fermeté, force
agobio : stress, angoisse
compostura : tenue, sang-froid
abrumar : accabler, troubler
eufemismo : euphémisme
cobrar : toucher, encaisser, faire payer
espetar : lancer, balancer
medicarse : prendre se médicaments
sentenciar : déclarer, condamner
arrimar el hombro : donner un coup de main
asombrar : émerveiller, impressionner, étonner
desazon : malaise, inquiétude, contrariété
airado : fâché, en colère
acurrucarse : se blottir
sacar a alguien de sus casillas : mettre qqn hors de soi
capa : couche (plusieurs couche)
quejica : pleurnicheur, râleur
hacerse cuesta arriba : avoir du mal à faire qch
deslomar : esquinter
desperdiciar : gaspiller
en sus trece : sur ses positions
atender a razones : entendre raison
brindar : offrir
trascendental : important, fondamental
duelo : deuil
enrabietarse : se mettre en colère
anonadado : abasourdi
inasequible : inaccessible
burrada : ânerie, énormité, bêtise
enchufe : prise de courant, prise électrique
empanarse : somnoler, s'assoupir
matutino : matinal
bache : mauvaise passe
desconcierto : confusion, perplexité
amarga : amer, déplaisant
asombroso : surprenant, épatant, impressionnant
colar : glisser, introduire en cachette
aprensivo : hypocondriaque
hacer alarde de : faire l'étalage de
docente : enseignant, professeur
hundido : abattu , effondré
calificar : noter, donner une note
a un tiro de piedra : à deux pas
germinar : germer
adentro : à l'intérieur
negrero : tyrannique
clavar : planter
perdiz : perdrix
calceta : tricoter
ausadia : audace
torpeza : maladresse, bourde
pesimo : piètre, très mauvais
fuera de quicio : furax, hors de soi
tamano : si grand, pareil, tel
desprevenido : au dépourvu, à l'improviste
ahorcarse : se pendre
callado : silencieux
diligencia : rapidité, vitesse
sobreseimiento : non-lieu
ponente : conférencier, intervenant
actuacion : spectacle, représentation
ensanamiento : acharnement
vejatorio : vexatoire, dégradant
menosprecio : mépris
escarmiento : leçon
atenuante : circonstance atténuante
caseta : maisonnette, cabane
baboso : baveux
plazo : terme, échéance
dilatar : différer, retarder
extinguir : éteindre
bote : canot, barque
escorar : gîter, s'incliner (nautique)
arrojar : aboutir à, se solder par
vispera : la veille de
frente : front
acopio : quantité, quantité
estanteria : étagère
sobresaltar : faire sursauter
romper : casser, briser
rotundo : net, retentissant, catégorique
hoyuelo : fossette
cartel : affiche
carnoso : charnu, pulpeux
indagar : enquêter, rechercher
abofetear : gifler
mejillon : moule (mollusque)
tormenta : tourmente
rastro : marché aux puces
carisma : charisme
portatil : ordinateur portable
reverenciar : vénérer, honorer
pleitesia : rendre hommage à
cuatro por cuatro : 4x4
velado : voilé, occulté, caché
revolver : examiner, fouiller
desvanecer : effacer, dissiper
butaca : fauteuil
picara : rusé, futé
aliviar : soulager, calmer
flaquear : faiblir, flancher
remolon : paresseux, fainéant
borrachera : cuite, ivresse
vello : poils, duvet
pezon : téton
pecoso : couvert de taches de rousseur
pitillo : slim
aguantar : s'empêcher, se retenir
castigador : punisseur
encadenar : enchaîner
desacertado : incorrect, inexact
entrega : dévouement
roer : ronger
flanco : flanc
otorgar : octroyer, donner
ansiado : désiré, convoité
comprometido : réservé
varon : garçon, homme
arrecife : récif
regar : arroser
molestia : ennui, désagrément
desembolso : dépense
vinculante : qui lie, contraignant
bodega : cale (bateau)
perito : expert
beligerancia : opposition, affrontement
telefonillo : interphone
tacho : récipient
salero : entepôt de sel
empantanado : barricadé
pufo : arnaque
estallido : explosion
alla : là-bas
traer al pairo : s'en ficher, s'en moquer
por si las moscas : au cas où
menudo : insignifiant, mineur
apostillar : commenter
cortar el bacalao : mener la barque
dar cana : secouer, mettre la pression
lloriquear : pleurnicher
dar bola a alguien : donner le l'importance à qqn
refanfinflar : s'en foutre
acceder : accepter
floreja : faiblesse
agasajar : recevoir chaleureusement
disparate : bêtise, ânerie
muermo : ennui
descojonarse : se bidonner
llevar la voz cantante : mener la danse
escaquearse : se défiler, se débiner
pelmazo : débile
capilla : chapelle
encapotar : couvrir
agobiante : oppressant, étouffant
tumulto : tumulte, cohue
encoger : rétrécir, replier
tejido : tissu
lapida : pierre tombale
sollozo : sanglot
contraproducente : contre-productif
operario : ouvrier
sellar : sceller
trastabillar : trébucher
arrear : déclencher, flanquer (gifle, coup de poing)
amago : esquisse, feinte
quebrar : briser, casser
nato : inné, né
estirpe : descendance, lignée
cuenta : gain, perle
fiera : bête féroce, fauve
lozano : vigoureux, solide
pulirse : liquider
habladuria : commérage
cotilleo : ragot, potin
no reparar en gastos : ne pas faire d'économies, ne pas lésiner
vajilla : vaisselle
lucir : porter fièrement, arborer
desembarcar : débarquer
presumir : se vanter
como oro en pano : comme sur la prunelle de ses yeux
juerga : fête
hermanarse : se rapprocher
mitificar : idéaliser
hueso : dur, impotoyable, vache
escabullarse : s'échapper
moribundo : moribond, mourant
semejante : tel, telle
socarron : narquois
estribillo : refrain
pala : pelle
salero : style, allure, charme
acatar : obéir à, respecter
desvivir : se démener pour
lana : laine
adecentarse : se préparer
trago : expérience douloureuse, coup dur
derribar : démolir
estremecer : ébranler
sana : rage
dolido : blessé
sobrepasar : dépasser
indagar : enquêter sur
rizar : friser
desafiante : provocateur
espatarrar : écarter les jambes
rozar : frôler
redicho : chochotte, gnangnan
mandibula : mâchoire
legible : lisible
sustentar : soutenir
convincente : convaincant, persuasif
solvencia : solvabilité
a la legua : de loin
descaro : insolence
traspapelar : égarer, perdre
afan : efforts
blando : moelleux, doux
dar la talla : être à la hauteur
lavavajillas : lave-vaisselle
inmune : immunisé
holgar : être inutile
derrumbar : démolir, abattre
lubricar : lubrifier
truquillo : combine
nimio : insignifiant
diversion : distraction, passe-temps
estragar : ravager (physiquement)
cenutrio : ballot, stupide
no pinta nada : être déplacé, mal venu
desistir : renoncer à
malhumorado : de mauvaise humeur
canuto : pétard, joint
malograr : gâcher
sacar de quicio : énerver, taper sur les nerfs
pinzar : pincer
crujir : ruer de coups
aprieto : embarras, pétrin
escritorio : bureau
dar la murga : bassiner, emmerder
zorra : salope
sinverguenza : culotté, gonflé
portal : entrée
bravata : menace
tela de : vachement, rudement
extremadamente : extrêmement
tetrico : lugubre, sinistre
bulla : vacarme, tapage, chahut
cortina de humo : écran de fumée
redito : bénéfice
obrero : ouvrier
arriesgar : risquer
enredar : ambrouiller
cebarse : s'acharner sur
acusar : accuser
husmear : renifler
repisa : étagère
casete : cassette
chasco : déception
afeitar : raser
tirita : pansement
apilar : empiler
delatar : dénoncer
progreso : progrès
mofarse : se moquer
cavernicola : homme des cavernes
atisbo : lueur
reunificacion familiar : regroupement familial
presa : barrage
cagon : trouillard, pétochard
lomo : dos
cohibido : introverti, renfermé, coincé
acariciar : caresser
mosqueado : en colère
lerdo : bête, lent d'esprit
ofuscacion : aveuglement, confusion
aliviar : soulager
tirador : tireur
asumible : acceptable, supportable
cordura : raison, sagesse
destierro : exil
liarse la manta a la cabeza : foncer la tête baissée
sinsentido : non-sens
pista : circuit
cabron : connard, enfoiré, saulaud
pendiente : côté, pente
colmar : remplir à ras bord
conato : tentative
bronca : engueulade
ameno : agréable, divertissant
marica : tapette, pédale
desencajar : dérégler
mareo : mal au coeur
carcomer : ronger
taller : atelier
nene : gamin, gosse
muermo : ennuyeux, rasoir
escabullirse : s'échapper, se défaire
exentar : exempter
amazona : cavalière
ansioso : impatient
chanchullo : escroquerie, magouille
asolar : dévaster, ravager, détruire
a rajatabla : au pied de la lettre
cuentagotas : compte-gouttes
echar la pota : vomir
liarse : se tromper
ansia : désir, envie folle
morboso : pervers, tordu
afan : ambition, volonté
puntilla : petit couteau
aguarras : essence, white-spirit
darle bola a : donner de l'importance à
lamer : lécher
amargo : amer
manosear : tripoter
galosina : friandises
zafar : libérer, retirer, extraire
inusitado ; inhabituel
descomunal : énorme, gigantesque
perra : pute, salope, chienne
apiadarse : avoir pitié
dudar : hésiter, douter
interponer : interposer
levantar la liebre : rendre public
fama : célébrité, renommée
costo : haschich
pillar : attraper, coincer, surprendre
tan pronto como : dès que, aussitôt que
diario : quotidien, journalier
de un plumazo : d'un coup, en un clin d'oeil
despojar : dépouiller
cochambroso : crade, dégueulasse
nudillo : articulation du doigt
desconchon : écaillure
mancha : tâche
moho : moisi, moisissure
asfaltar : goudronner
socavon : nid-de-poule
ensayar : répéter
escalon : marche
acomodarse : s'installer, se mettre à l'aise
alumbrar : éclairer
empanar : embuer
desvio : déviation
serenar : apaiser, calmer
constancia : preuve
salpicadero : tableau de bord
vanagloriarse : se vanter de
compincharse : se liguer, comploter
pinchar en hueso : tomber sur un os
bicho : bête, bestiole
verja : grille
asco : dégoüt, répugnance
pedalear : pédaler
corroer : ronger, éroder
llano : plat
despejado : dégagé
diluviar : pleuvoir à verse
sacudirse : se débarrasser
caldear : chauffer
poblado : village
fardar : frimer
en pelota : à poil
atiborrarse : se gaver, se goinfrer
parienta : femme, bourgeoise
chapotear : patauger, barboter
faena : tâche, travail
cuesta : côte
alarde : étalage
despliegue : déploiement, étalage
desfallecer : flancher, faiblir
valla : clôture, palissade
casco urbano : centre-ville
ensueno : rêve
mojigato : prude, coincé
remedo : copie, contrefaçon
multitudinario : massif, nombreux
sibarita : raffiné, épicurien
codazo : coup de coude
cachete : claque, gifle
bribon : filou
previsor : prévoyant
transcurrir : s'écouler, passer
enfrascarse : s'absorber dans, se plonger dans
pinche : commis de cuisine
rulo : bigoudi
bata : robe de chambre
asombrar : étonner, stupéfier
intermitente : clignotant
escasez : pénurie
pellizco : pactole, coquette somme
garrafal : monumental, colossal
astillero : chantier naval
altibajo : mauvaise passe
menear : remuer
la pregunta del millon : la question à un million d'euros
elucubrar : imaginer, élaborer
amargura : amertume
ruborizarse : rougir
albergar : abrîter, héberger
esparcir : étaler
sobornar : soudoyer, acheter, corrompre
monigote : pantin, bonhomme
ahorcado : pendu
mogollon : un paquet de, un tas de
belligerante : hostile, agressif
a las mis maravillas : à merveille
rebuscar : fouiller
papelera : poubelle, corbeille à papier
guantera : boîte à gants
mendigo : mendiant
despejar : dégager, débarrasser
descalzarse : se déchausser
derramar : renverser, verser
echar por la borda : jeter par-dessus bord
veloz : rapide
bayeta : éponge, lingette
conmiseracion : compassion
acalorar : chauffer
apurar : presser, brusquer
agujerear : trouer, percer
alhaja : bijou
mono : mignon, joli
coger una curda : prendre un cuite
disparatar : divaguer, délirer
sangrar : saigner
portazo : claquement de porte
asombro : étonnement, stupéfaction
procurar : essayer de, chercher à
hacer el gamba : faire le pitre, faire l'andouille
noquear : mettre KO
espetar : lancer, balancer (oral)
hiriente : blessant, offensant, vexant
arrear : décocher, flanquer
valentia : courage, bravoure
acorralar : piéger, coincer
reconcomerse : être rongé par
mella : entaille, trou
percatarse de : se rendre compte de
juicio : avis, opinion
saltarse a la torera : ne pas suivre une obligation
hazmerreir : risée, dindon de la farce
pistoletazo : coup de pistolet
suavizar : adoucir, assoupir
tiza : craie
apaciguar : apaiser
instigador : instigateur
delinquir : commettre un délit
malograr : gâcher
restregar : narguer
estrujar : essorer
teniente : lieutenant
estampar : percuter
hechizo : sort, sortilège
rapapolvo : savon (répression)
prender : allumer (un feu)
operativo : efficace
atajar : contenir, stopper
mantel : nappe
estirado : hautain, arrogant
beber los vientos por alguien : être fou de
encerrona : embuscade
vicerrector : directeur adjoint
querella : plainte
patentar : breveter, délivrer un brevet
runrun : rumeur
atufar : sentir mauvais, puer
bochorno : chaleur étouffante
arenal : banc de sable
abrazar : prendre dans ses bras, étreindre, enlacer
prendarse : se laisser charmer
diminuto : minuscule
extirpar : retirer, extraire
bolero : menteur
acurrucarse : se blottir
dormir a pierna suelta : dormir à poings fermés
retrete : toilettes, WC
incomunicar : empêcher de communiquer, isoler
espeluznar : effrayer, terroriser
obcecar : aveugler
herir : blesser
cueva : grotte
franquearse : s'ouvrir à
recoveco : coin, recoin
aullar : hurler
gaviota : mouette
demacrado : amaigri
candado : cadenas
aliento : souffle
empapar : tremper
sobaco : aisselle
embadurnar : enduire, badigeonner
paredon : poteau d'exécution
escoria : racaille, vermine
resguardo : abri
puntilla : coup de grâce
estocada : blessure (à l'arme blanche)
disponerse a : avoir l'intention de
cubiculo : cabine
plateado : argenté
jaleo : raffut, tapage, bazar
alborotado : agité
despejarse : se changer les idées
trancazo : crève (grippe)
cuchitril : taudis
grasiento : gras
jalar : tirer
fisgonear : fouiller
demudarse : changer, se transformer
mocoso : morveux
cerciorarse : s'assurer, vérifier
aguardar : attendre
arriero : muletier
molinero : meunier
herradura : fer à cheval
desbandada : débandade, bébâcle
rastrero : vil, mesquin
chulo : fanfaron, frimeur
sobrado : impertinent, insolent
cerda : truie, cochonne
bocanada : bouffée, bol d'air
acicalarse : se faire beau
contraventana : volet
persiana : store
rematar : tirer (ballon)
mimoso : câlin, affectueux
cavilacion : réflexion, méditation
blando : faible, chétif
calana : de la pire espèce
citarse : se donner rendez-vous
conveniente : opportun, judicieux
testimonio : témoignage
conyuge : conjoint
sonoro : sonore
volcar : faire part de, partager, confier
garrafal : monumental, colossal
aminorar : ralentir
hacha : hache
lena : bois, bois de chauffage
salir por peteneras : s'en sortir par une pirouette
manta : flemmard, fainéant
cenicero : cendrier
cuajo : nonchalence
cazadora : veste, blouson
cuero : cuir
fiestero : fêtard
alterar : rendre nerveux
ensuciar : salir
cansancio : fatigue
mampara : cloison
empalagoso : écoeurant
obsequiar : offrir
mordisco : morsure
escondite : cachette
farol : bluff
retratar : dessiner, peindre
aquiescencia : accord, permission
azuzar : exciter
enzarzarse : se disputer
cohibir : intimider
escandalo : bruit, tapage, boucan
alameda : allée, promenade
cerrojo : verrou
desenmascarar : démasquer
calibrar : évaluer
temeroso : craintif, peureux
estupefacto : stupéfait, pantois
yugular : asphyxier
faldero : petit chien, toutou
regodearse : se réjouir
amargado : aigri
mazazo : coup de massue
fisgon : fouineur
acoso : harcèlement
agarrarse a un clavo ardiendo : se faire des illusions
repuntar : émerger
chubasquero : imperméable, k-way
oscurecer : la nuit tombe, s'obscurcir
pretender que : vouloir que
chorrear : couler, dégouliner
espectro: fantôme, spectre
desparramar : étaler, répandre
altillo : grenier
campana extractora de humos : hotte aspirante
linterna : lampe de poche, torche électrique
arreciar : s'intensifier
chillar : crier, hurler
alambrada : clôture
trueno : tonnerre, coup de tonnerre
rayo : foudre
bordear : longer
fogonazo : éclair
ladera : flanc, versant
agazaparse : se tapir
zarza : ronce
matojo : buisson
pincho : pointe, pique
embarrar : couvrir de boue
impotencia : impuissance
cojo : boiteux
aupar : encourager
chillido : cri, hurlement
caerse de bruces : tomber la tête la première
barro : boue, gadoue
meta : ligne d'arrivée
tobillo : cheville
empapar : absorber, éponger
acobardar : se dérober, se dégonfler
consuelo : consolation, réconfort
hocico : museau
aguacero : averse, pluie
callejuela : ruelle
perdido : crade
respingo : sursaut
a palo seco : d'un coup
descabellado : tiré par les cheveux
empalmarse : bander (érection)
pringoso : collant, gluant
aparador : vitrine
apacible : paisible, calme
sigilo : discrétion
potingue : crème cosmétique
adefesio : mocheté, laidron
toalla : serviette
refunfunar : grommeler, bougonner, râler
quirofano : bloc opératoire
desenlace : dénouement
alcance : effet, importance
escudrinar : scruter, examiner
teson : détermination, persévérance
resorte : ressort
violentar : gêner, contrarier
taxista : chauffeur de taxi
empenar : mettre en gage
desbocarse : se déchaîner
profugo : fugitif
remate : tir, frappe
aguantar : soutenir, porter
sopesar : soupeser
tejado : toit
estampa : image, illustration
inasequible : exorbitant, inabordable (prix)
reembolsar : rembourser
eximir : exempter
portada : première page
repunta : cap
derrotar : vaincre
arrebatarse : s'emporter, se fâcher
jarro : pichet, cruche
tipejo : type, sale type
aval : garantie
disparate : folie, fou, folle
entrampar : piéger
reflotar : remettre à flot
lastimoso : pitoyable
iman : aimant
insalvable : insurmontable
irse al trase : tomber à l'eau
desvario : bêtise, absurdité
encubierto : dissimulé, caché
increpar : réprimander
surtir efecto : faire effet
cuajar : prendre forme, se concrétiser
malherido : blessé grave
pergenar : ébaucher
alumbrado : éclairage public
suplir : remplacer
escaparate : vitrine
vericueto : chemin escarpé
cortapisa : contrainte, obstacle
inducir : inciter
empatizar : compatir
pudiente : riche, puissant
sonsacar : soutirer
dudoso : suspect, louche
cantar : chanter
tira y afloja : lutte acharnée
desinflar : dégonfler
aprieto : problème économique
trizar : fêler, fissurer
macizo : massif
abejorro : bourdon
corral : enclos
festejar : célébrer
lata : boîte de conserve
bisabuelo : arrière-grand-père
infante : enfant
charol : cuir vernis
gallinazo : vautour
alambre : fil de fer
proveer de : approvisionner de
solapar : couvrir, recouvrir
nalgada : fessée
silla de ruedas : chaise roulante
horquilla : épingle à cheveux
bellaco : scélérat, voyou
truhan : truand, voyou, escroc
mascullar : marmonner
muslo : cuisse
arropar : couvrir, emmitoufler
trinitaria : pensée (fleur)
gamuza : daim
tibieza : tiédeur
hiedra : lierre
rocio : rosée
sequito : conséquence
delantal : tablier
postizo : faux