zurra : raclée, tannée
agudo : vif
terso : lisse
llanta : jante
luna : vitre
dar la paliza : emmerder, faire chier
sacudida : secousse
incorporarse : se redresser
haz : faisceau
gorra : casquette
calar : pénétrer, s'infiltrer
dedo indice : index (doigt)
librar : être libre, ne pas travailler
recelar : se méfier
letrero : panneau, pancarte
pulir : polir, lustrer
impoluto : intact, pur
recorrido : parcours, itinéraire
adosado : mitoyen
sobresalir : se distinguer
finca : propriété, domaine
calzada : chaussée, route
cariz : tournure
grillo : grillon
apresurar : précipiter
farola : lampadaire
vislumbrar : entrevoir, deviner
portalon : portail
atravesar : transpercer
bordillo : bordure
la vispera : la veille
ceniciento : abattu, démoralisé
atenerse a : s'en tenir à
terso : lustré, brillant
carraspear : toussoter, se racler la gorge
luna llena : pleine lune

estrellarse : s'écraser, percuter

arder : brûler, embraser
hombrecillo : petit homme
chasquear : claquer
irse a la verga : aller se faire foutre
atascarse : s'embourber, s'enliser
trazar : tracer
plomo : plomb
chirrido : grincement
pisar : appuyer sur, marcher sur
platear : couvrir d'argent
convenir : être bon pour quelqu'un
nutrir : nourrir
baldosa : dalle, carreau
caliza : calcaire
tenir : teindre, teinter
destello : scintillement, éclat
doblar : tourner (direction)
mono : bleu de travail
calada : bouffée, taffe
correa : laisse, sangle
reticencia : réticence
arruga : faux pli
perchero : portemanteau
echarse : se pousser, se baisser
templado : tiède
apanarselas : se débrouiller, se démerder
lujo : luxe
terreno : domaine
cortado : timide, réservé
inabarcable : trop vaste
tragaluz : lucarne
bandolera : bandoulière
colgar : accrocher, pendre
fugaz : fugace
de sobra : en trop
cuchillada : coup de couteau
latido : battement (coeur)
rajar : découper, couper
mortecino : éteint, mourant
rebosar : déborder
negruzco : noirâtre
ceruleo : bleu ciel
arcada : nausée
cuclillas : accroupi
doblarse : se plier, se tordre
cristiano : chrétien
borde : grossier, malpoli
cholar : mépriser
aniquilar : anéantir
apartarse : s'éloigner, s'écarter
obvio : évident
trastorno : dérangement, désagrément
nineria : enfantillage
impulsar : encourager, stimuler
practicar : s'entraîner
yema : bout du doigt
actuacion : intervention, agissement
pillarse por alguien : flasher sur quelqu'un
cruz roja : croix-rouge