dieta : régime
trepar : grimper
hostigar : harcerler
atadura : attache
panuelo : foulard
tumbar : renverser
aduana : douane
prescindir de : se passer de
desmantelar : démanteler
arancel : droit de douane
incentivar : stimuler, encourager
recorte : coupe budgétaire
sembrar : semer
inmune : immunisé
aflojar : desserrer, détendre
caducar : périmer
lema : devise, slogan
demandar : poursuivre
desembocar : déboucher sur
aferrarse : s'accrocher
denegar : refuser, rejeter
coraje : courage
balacera : fusillade
brecha : brèche, fissure
aforo : capacité
escarnio : humiliation, moquerie
encarar : faire face à
lidiar : combattre, faire face à
periodo de prueba : période d'essai
esquematico : schématique
pedido : commande
a corto plazo : à court terme
liquidez : liquidité
recomponer : recomposer
sabana : drap
fluir : couler
escalar : escalader
desafio : défi
chocar : percuter
desleal : déloyal
machacon : pénible, insistant, lourd
agradar : plaire
centavo : centime
clavar : planter, enfoncer
antojarse : imaginer, avoir l'impression
heredar : hériter de
solvencia : solvabilité
rozar : frôler
comprometido : risqué
adentrarse en : entrer dans, pénétrer dans
reparo : objection
leve : léger
ademan : geste
comprometedor : compromettant
pandilla : bande
inepto : inapte
muela : molaire
hediondo : puant, nauséabond, répugnant
presa : proie
carecer : manquer de
hurgar : fouiller
obsequio : cadeau
chapucero : bâclé, négligé
perplejo : perplexe
herejia : hérésie
tela : tissu
costura : couture
machaconamente : avec insistance
vislumbrar : entrevoir, apercevoir
anfitrion : hôte
insensatez : manque de bon sens
barro : boue, gadoue
poseer : posséder
disenar : concevoir
asentar : stabiliser, renforcer
enfocar : faire la mise au point de
rojizo : rougeâtre
deslumbrar : éblouir
ensangrentado : ensanglanté
aperreado : minable, misérable
sujetar : tenir
pulso : pouls
vejacion : vexation, humiliation
jovenzuelo : gamin
acarrear : entraîner, amener, provoquer
aseveracion : affirmation
reja : grille, barreaux
apretar : serrer
grueso : épaisseur
desmadrarse : sortir de ses gonds
ventanal : baie vitrée
razonamiento : raisonnement
escaso : rare
oficio : métier
sumamente : extrêmement
arrasar : ravager, détruire
rotura : rupture, cassure, fracture
tuberia : tuyauterie
averia : panne, défaillance
advertir : remarquer, constater
grano : bouton (peau)
renir : réprimander, gronder
renguear : boiter
peca : tâche de rousseur
mestizo : métis
chalé : pavillon, villa
hundir : faire couler
reganar : gronder, disputer
sena : indice, signe
fundir : aplatir, déformer
inquilino : locataire
afuera : banlieue, périphérie
las senas : adresse (domicile)
roer : ronger
bendicion : bénédiction
musitar : chuchoter
rezo : prière
en torno a : autour de
alforja : saccoche
desatar : détacher
tropezar con : trébucher sur, se cogner contre
asomar : apparaître, pointer le bout de son nez
dichoso : heureux, chanceux
falda : flanc
dichoso : foutu, satané, maudit
resguardarse : se protéger, s'abriter
manojo : bouquet (de fleurs), trousseau (de clés)
arrebujarse : s'emmitoufler
almohada : oreiller
sanar : guérir
apartar : pousser, déplacer, écarter, mettre de côté
santidad : saineté
saudade : nostalgie, mélancolie
cenicienta : cendré (couleur)
al cabo de : au bout de
poniente : couchant
alla : autrefois, jadis
labrar : façonner
cornisa : corniche
escudo : emblême
linaje : lignée
umbral : seuil
estribo : étrier
castano : châtaigner
vidriera : vitrail, vitrine
vidrio : vitre
desasirse : se libérer de
alzar : lever
nuevamente : de nouveau
ancho : large
losa : dalle, pierre, plaque
lapida : pierre tombale
escano : siège, banc
roble : chêne
lustroso : brillant, lustré
usanza : usage, mode
arcon : coffre
trigo : blé
tapa : couvercle, capuchon
criada : domestique, servant