inane : vain, inutile
anochecer : coucher de soleil
tendido : allongé
oido : audition, ouïe
afilado : taillé, aiguisé
cera : cire
mascara : masque
soplo : souffle
agrietar : gercer
testimonio : témoignage
cincel : ciseau
flequillo : frange
rebelde : rebelle
ahuecar : creuser
destaparse : se révéler, se découvrir
palma : paume
cuadrado : carré
latir : battre
cortesia : courtoisie, politesse
cuota : cotisation
coronilla : crâne
clavar : clouer
embolo : piston
barra : bar, comptoir
lata : boîte de conserve, canette
deslavazado : insipide, fade
acatarrado : enrhumé
apreton : serrement, poignée de mains
enternecer : attendrir
pepino : concombre
macizo : massif
allanar : forcer, entrer par effraction
grasiento : gras
apego : attachement, affection
acallar : faire taire
escueto : simple, sobre, modeste
enfrascarse : s'absorber dans, se plonger dans
alejar : éloigner
yegua : jument
maquinaria : machines, engins
perra suerte : poisse
envilecer : avilir
olisquear : renifler
farol : lanterne
guinar : faire un clin d'oeil
tarado : taré, dingue
pulgada : pouce
zancada : foulée, enjambée
rechoncho : rond, dodu
calvo : chauve
traslucir : laisser entrevoir
aliento : souffle
exhausto : exténué

monicaco : faible
agallas : cran, courage
torneo : tournoi
ahorcar : pendre
punzada : élancement
chillar : crier, hurler
desgarrador : déchirant, poignant
desmadejar : affaiblir
chasquido : claquement
rasposo : râpeux
punzante : pointu, aigu
martilleo : martèlement
a proposito : exprès
tambor : tambour
mandibula : mâchoire
sollozar : sangloter
repentino : soudain
raton : souris
roedor : rongeur
amargar : donner un goût amer
paladar : palais
rodapié : plinthe
carrillo : joue
a reganadientes : à contre-coeur
pugna : lutte, bataille
retortijon : crampe
desvio : détour
atronador : étourdissant
metalico : métallique
ciego : aveugle
auxilio : aide
roncar : ronfler
jadeo : respiration difficile
pulmon : poumon
desfallecer : s'évanouir
retumbar : retentir, résonner
enmudecer : rester muet
garganta : gorge
fuelle : soufflet
recorrido : parcours, itinéraire
contrasena : mot de passe
marear : faire tourner la tête
gatear : marcher à quatre pattes
negrura : noirceur, obscurité
resquebrajarse : se fendiller, se fissurer
susurro : chuchotement
conejo : lapin
sollozo : sanglot
zumbar : bourdonner
sobresalto : sursaut, frayeur
encogerse : se recroqueviller, se replier
remate : tir, frappe (foot)
trastabillar : trébucher
puntiagudo : pointu
surtidor : jet
oido : oreille
congoja : angoisse
rina : dispute