toscamente : grossièrement
senorial : seigneurial, majestueux
peldano : marche, barreau (échelle)
labrado : travaillé, taillé
vuecencia : votre excellence
echado : allongé, couché
echarse : se coucher, s'allonger
estancia : séjour, pièce
criar : nourir, alimenter
agredir : agresser
almacen : entrepôt, magasin
escupir : cracher
conllevar : impliquer, comporter
sede : siège
rayado : fou, cinglé
necio : bête, idiot, imbécile
sello : cachet
arrepentirse : regretter
encontronazo : collision, altercation
emprender : entreprendre
hundirse : se laisser aller, déprimer
punteria : précision, adresse
rodeo : détour
fichar : surveiller, ficher
doblete : doublure
chuleta : insolent
espejismo : mirage, illusion
grua : grue
alargarse : se prolonger
puja : enchère
apanar : réparer, rafistoler
foco : projecteur, spot
chispa : étincelle
pujar : se battre, lutter
subastar : mettre aux enchères
novato : novice, néophyte
fallo : jugement, verdict
rehen : otage
alto al fuego : cessez-le-feu
coleta : aileron
burlar : semer, esquiver
prever : prévoir
orilla : bord
difundir : diffuser, répandre
aludir : faire allusion à
enfocar : faire la mise au point de
atracar : braquer, dévaliser
mula : mule
abaratar : solder, baisser les prix
entidad : établissement
enriquecer : enrichir
pedazo : bout, morceau, tranche
trozo : bout, morceau
alargar : allonger, étendre
rodear : contourner, faire un détour
machacar : écraser
currar : bosser, taffer
rollo : liaison, flirt
arrimar : approcher, rapprocher
juntar : joindre, réunir
invertir : investir
tocadiscos : tourne-disque
entorno : environnement, entourage
deshacer : liquider, fermer boutique
confundir : déconcerter, dérouter, confondre
prospeccion : prospection, sondage
hurgar : fouiller
adoptar : adopter
palabreria : baratin
curro : boulot
talonario : carnet de chèque, chéquier
folleto : brochure
hacerse pupa : se faire bobo
arremangar : se retrousser les manches
huevo : couille
sierra : scie
competer : relever de la compétence de
bastar : suffire
sobredosis : overdose
marear : faire tourner la tête, donner la nausée
mercancia : marchandise
camello : dealer
avena : avoine
disidente : dissident
testificar : témoigner
marron : tuile, galère
asesoria : cabinet de conseil
independizarse : prendre son indépendance
madero : flic, keuf, condé
guarro : cochon
rueda de prensa : conférence de presse
encrucijada : croisement, carrefour
alcance : portée
franqueza : franchise
mear : pisser
difunto : décédé, défunt
empate : match nul, égalité
fuera de juego : hors-jeu
exito : succès, gloire
brevedad : brièveté
desencajado : décomposé, bouleversé
aprieto : embarras, pétrin
engendrar : mettre au monde
atarear : occuper
tosco : grossier
abrumar : accabler, troubler
horrendo : horrible, moche
renacuajo : petit, bout de chou
cabezota : grosse tête
hortera : ringard, kitsch
memez : niaiserie
clasista : élitiste
sorber : aspirer
antepasado : ancêtre
embobado : abasourdi
fullero : trompeur
tropelia : abus
asentir : consentir, acquiescer
canalla : voyou
golfa : pute, salope