prisa : hâte, empressement
crio : gamin, enfant
batallita : anecdote
fritar : frire
hundir : provoquer l'effondrement
alejar : éloigner
desfogar : décharger, relâcher, défouler
pijo : bourgeois
pesado : lourd, pénible
redondo : rond
parada : arrêt, pause
desperdigar : éparpiller
ratonera : piège
mala hostia : mauvaise humeur
efectivo : espèces, argent liquide
alcanzar : atteindre
plazo : délai
desplegar : déployer
pedazo : morceau, tranche
escobilla : brosse (pour WC)
jabon : savon
rendir : donner des résultats
polvo : poussière
alentar : encourager
vacunacion : vaccination
ratonera : tapette à souris
aterrar : terrifier, effrayer
entornar : laisser entrouvert
ambientar : décorer
patinete : trotinnette
rapero : rappeur
tesis : thèse
talego : sac
blanqueo : blanchiment
despedirse : dire au revoir
despedir : licencier, renvoyer
ascenso : ascension
prometido : fiancé
talego : taule, gnouf, placard
esencia : essence
rehabilitacion : rééducation
investigar : enquêter
pijo : bourgeois
investigar : rechercher, étudier
saldo : solde
portazo : claquement de porte
presupuesto : devis, budget
capullo : con
singular : singulier, unique, spécial
rehabilitacion : désintoxication, réhabilitation
pillar : attraper, rattraper
castigo : punition, châtiment
debilitar : affaiblir
tramitar : faire les démarches
izar : hisser
receso : pause
punada : coup de poing
alegar : prétexter, alléguer
tremendo : horrible, terrible
redondo : impeccable
duplicar : doubler, dupliquer
especular : spéculer
pastizal : pré, pâturage
trazar : tracer
hostia : putain, merde
darle a alguien una hostia : casser la gueule à quelqu'un
labor : tâche, travail
tiroteo : fusillade
comodin : excuse, prétexte
destacar : souligner, mettre l'accent sur
polvo : baiser, tirer un coup
proceder : venir de, provenir de
franja : bande (Gaza)
cohete : fusée, roquette
cobrar : toucher, encaisser
sobrante : restant, en plus, trop
hundir : anéantir
cello : cercle
discografica : maison de disque
solear : mettre au soleil
vela : bougie
pinchar : piquer
rodear : contourner
ratero : voleur
majo : sympa, gentil
atreverse : oser
pija : bite, queue
orinar : uriner
joder : faire chier
escarpe : pente, dénivelé
fracasar : échouer
tirarse : se jeter, plonger
rendirse : se rendre, s'avouer vaincu
boya : bouée
bandeja : plateau
pirarse : se casser
mechero : briquet
curre : boulot, taf
a tomar por culo : aller se faire foutre
gilipollas : con, abruti
calar a alguien : percer à jour, démasquer
pincha : travail, métier
aguja : aiguille
rodado : routier
proveedor : fournisseur
apretar : serrer, presser, compresser
chupatintas : gratte-papier
ambito : domaine, secteur, milieu
jodido : foutu
encajar en : être à sa place, se sentir à sa place
soso : fade, insipide, terne
callejon : ruelle
cinta : ruban
aparentar : prétendre, feindre
fracasado : raté
carpintero : menuisier
dispuesto : prêt, prêt à faire qch
comodin : homme à tout faire
quitar : enlever
arrebatar : arracher
echao : allongé, couché
fiscal : procureur
asociado : associé
bote : boîte, pot
mote : surnom
enfrentamiento : affrontement
incidir : affecter, influencer, avoir une incidence sur
trazar : élaborer, planifier
senal : signe, geste
joder : baiser
desprecio : mépris
borrador : gomme
atemorizar : terroriser, effrayer
desestimar : rejeter
alegar : contester
inquina : aversion, dégoût, haine
cabrear : énerver, péter les plombs
enano : nain
verborrea : logorrhée, verbosité
caza : chasse
suscripcion : abonnement, souscription
abono : abonnement
buchaca : poche
palacete : manoir, hôtel particulier
recalada : escale
conazo : chiant, emmerdant
proceder : agir, procéder
desplomarse : s'effondrer
demonio : diable, démon
desatar : déclencher
cartel : cartel
cesto : panier
enfoque : point de vue, approche
curar : soigner
cerilla : allumette
caja : caisse, boîte
afortunado : chanceux, heureux, privilégié
recopilar : compiler, assembler
borrador : brouillon
becada : bécasse
guarro : dégueulasse, crade
recetar : prescrire
extraoficial : officieux
ensayar : tester
coger : attraper, arrêter
gatillo : gâchette
enterarse : se rendre compte
descojonarse : se foutre de, se bidonner
sorteo : tirage au sort
espejismo : mirage, illusion
salvavidas : bouée de sauvetage
punetero : emmerdeur
encuadernar : relier
folleto : prospectus
adquirir : acquérir
sujeto : individu
carnicero : carnivore
aliado : associé
cursar : étudier
desprenderse de : se débarrasser, se défaire
bucear : plonger, nager sous l'eau
charca : mare
escurrirse : glisser
aseado : propre, soigné
grifo : robinet
parroquiano : habitué
impactante : impressionnant
alegar : alléguer, prétexter
agrado : goût
metalico : espèces, liquide, cash
ansiar : avoir très envie de
umbral : seuil
cruzar : traverser
constarle a alguien : être sûr de 
porton : portail, grande porte
contribuyente : contribuable
preludio : prélude, début
despreciar : mépriser, dédaigner
alargar : allonger, rallonger
libidinoso : libidineux
miron : curieux, voyeur
aflorar : émerger
matizar : nuancer, atténuer
pupila : élève
aligerar : alléger
procedencia : origine, provenance
fingir : faire semblant de
aguardar : attendre
eldredon : couette
peldano : marche, barreau (échelle)
tramite : procédure, démarche
desvelar : empêcher de dormir, maintenir éveillé
reventar : éclater
susurro : chuchotement, murmure
macarra : voyou
acertado : judicieux, adéquat
nutrido : nombreux
rebotar : rebondir
fisgonear : fouiller, fouiner
entrometerse : se mêler des affaires des autres
lamer : lécher
migaja : miette de pain
enfundarse : enfiler
albornoz : peignoir
malva : mauve
apatico : apathique, amorphe
malgastar : gaspiller
semilla : semence
antemano : à l'avance, d'avance
fecundar : féconder
abocar : transvaser
azotar : fouetter
abundar : abonder, foisonner
semen : sperme
aro : anneau
derrochar : gaspiller, dilapider
ensayar : répéter
atarear : occuper
alabanza : éloge
manejar : diriger, gérer
machacon : pénible, insistant, lourd
agradar : plaire
centavo : centime
clavar : planter, enfoncer
antojarse : imaginer, avoir l'impression
heredar : hériter de
solvencia : solvabilité
rozar : frôler
comprometido : risqué
adentrarse en : entrer dans, pénétrer dans
reparo : objection
leve : léger
ademan : geste
comprometedor : compromettant
pandilla : bande
inepto : inapte
muela : molaire
hediondo : puant, nauséabond, répugnant
presa : proie
carecer : manquer de
hurgar : fouiller
obsequio : cadeau
chapucero : bâclé, négligé
perplejo : perplexe
herejia : hérésie
tela : tissu
costura : couture
machaconamente : avec insistance
vislumbrar : entrevoir, apercevoir
anfitrion : hôte
insensatez : manque de bon sens
barro : boue, gadoue
poseer : posséder
disenar : concevoir
asentar : stabiliser, renforcer
enfocar : faire la mise au point de
rojizo : rougeâtre
deslumbrar : éblouir
ensangrentado : ensanglanté
aperreado : minable, misérable
sujetar : tenir
pulso : pouls
vejacion : vexation, humiliation
jovenzuelo : gamin
acarrear : entraîner, amener, provoquer
aseveracion : affirmation
reja : grille, barreaux
apretar : serrer
grueso : épaisseur
desmadrarse : sortir de ses gonds
ventanal : baie vitrée
razonamiento : raisonnement
escaso : rare
oficio : métier
sumamente : extrêmement
arrasar : ravager, détruire
rotura : rupture, cassure, fracture
tuberia : tuyauterie
averia : panne, défaillance
advertir : remarquer, constater
desencajado : décomposé, bouleversé
aprieto : embarras, pétrin
engendrar : mettre au monde
atarear : occuper
tosco : grossier
abrumar : accabler, troubler
horrendo : horrible, moche
renacuajo : petit, bout de chou
cabezota : grosse tête
hortera : ringard, kitsch
memez : niaiserie
clasista : élitiste
sorber : aspirer
antepasado : ancêtre
embobado : abasourdi
fullero : trompeur
tropelia : abus
asentir : consentir, acquiescer
canalla : voyou
golfa : pute, salope
mendigo : mendiant
maleante : délinquant
hierro : fer
rebatir : réfuter, rejeter
estirpe : descendance, lignée
chachara : bavardage
payaso : clown, charlot, guignol
adefesio : mocheté
domador : dresseur
braguetazo : mariage intéressé
doquier : partout
aborrecer : détester, haïr
lelo : niais, bête, idiot
sandez : bêtise, sottise
nitidez : netteté
enfilar : mettre en file indienne
rotonda : rond-point
adentrarse en : entrer dans, pénétrer dans
vecinal : de voisinage
punado : poignée
pezon : téton
lenceria : lingerie
ejecutivo : de direction, cadre supérieur
lucirse : briller, se distinguer
apestar : empester, sentir mauvais
griego : grec
anteponer : faire passer avant
desorejado : dévergondé, dépravé
ufanarse de : se vanter de
arrear : décocher, mettre, flanquer
sopapo : claque
morboso : pervers, tordu
cotilla : commère
al raso : à la belle étoile
coro : choeur
desechar : dissiper, chasser
maletin : mallette, porte-documents
calzoncillos : caleçon, slip
transcurrir : s'écouler, passer
presupuesto : budget
verja : grille
tan solo : seulement, à peine
borroso : flou
desconsoladamente : inconsolablement
regentar : diriger, tenir
vertedero : décharge
cartero : facteur
gaznapiro : nigaud
zampar : engloutir
butaca : fauteuil
empecinado : obstiné, têtu
mentecato : idiot
mero : simple
recobrar : récupérer, retrouver
alabar : vanter, faire l'éloge de
lerdo : bête
cloaca : égout
airear : aérer
hedor : mauvaise odeur
sobornar : soudoyer, acheter
intachable : irréprochable
limosna : aumône
traspasar : transpercer, traverser
alivio : apaisement, soulagement
liebre : lièvre
aspero : rugueux
ombligo : nombril
anfitrion : hôte
respaldo : dossier (siège)
ladear : pencher, incliner
inquirir : demander, s'enquérir de
retador : avec défi
sentenciar : condamner
presupuesto : supposition, présomption
encogerse : rétrécir, replier
cromo : image, vignette
cajaro : border, merde
aplomo : aplomb, assurance, confiance
hojear : feuilleter
agradar : plaire, apprécier