manazas : empoté, avoir deux mains gauches
arrastrar : entraîner, emporter
aportar : cotiser, contribuer
inservible : inutilisable
bufido : rugissement, soufflement
dadiva : don, présent
vajilla : vaisselle
derroche : profusion, explosion
aplacar : calmer, apaiser
avalar : cautionner, soutenir
bocanada : bouffée, bol d'air
otorgar : octroyer
obsequiar : offrir, faire un cadeau
puro : cigare
disfraz : déguisement
ceja : sourcil
nuera : belle-fille
tumbar : renverser, mettre par terre
techo : plafond
procedente : originaire, en provenance
cierre : fermeture, clôture
presupuestario : budgétaire
interponer : déposer
vaticinar : prédire
pantomima : farce
plasmar : reproduire
vulneracion : violation
ponente : conférencier, intervenant
cauto : prudent
saque de banda : touche (football)
traspasar : déplacer, transférer
desempenar : exécuter, réaliser, effectuer
solemne : solennel
cese : renvoi, arrêt, interruption
comprometer : impliquer
recalcar : insister sur, souligner
suponer : signifier
poza : mare
descenso : descente
ruta : randonnée, parcours
racha : rafale
atrasar : retarder, ralentir
ocioso : oisif
arrullar : bercer
indomable : indomptable
aguzarse : s'aiguiser, se renforcer
antano : autrefois
achacar : attribuer à, imputer à
desenfrenado : effréné, insatiable
asombrar : émerveiller, impréssionner
nimio : insignifiant
ramera : prostituée, pute
arrumacos : caresses, mamours
coaccion : contrainte
empitonar : encorner
cornudo : cocu
malhadado : malchanceux
asador : barbecue, grill
chapotear : patauger
contravenir : enfreindre
crudo : cru
antojar : avoir envie de
tambalear : vaciller, chanceler
balbucear : bafouiller
procurar : veiller à, tâcher de
acertar : mettre dans le mille, viser juste
cerradura : serrure
fontanero : plombier
a destajo : d'arrache-pied
averia : panne, défaillance
caneria : canalisation, tuyauterie
paron : arrêt
besuquear : bécoter, couvrir de baisers
no importar un bledo : s'en ficher, s'en moquer
gaje : bonus
apalear : ruer de coups
lupanar : bordel
propasarse : manquer de respect
cabecilla : leader
apodar : surnommer
comadrona : sage-femme
quisquilloso : susceptible
grato : agréable, plaisant
recursos : recours, moyen
pleitesia : rendre hommage à
indulto : grâce (pardon)
saque de esquina : corner
colegiado : arbitre
desaire : affront
espantada : fuite
rebotar : rebondir
albergar : abriter, héberger
atender : recevoir, accueillir
contundente : ferme, catégorique
punetero : casse-pieds, chieur
encabezar : être à la tête de
diputado : député
asiento : poste, siège
embajador : embassadeur
respaldo : soutien, appui
tibieza : tiédeur
retorcer : tordre
claudicar : céder, abandonner
fomentar : promouvoir, encourager
boletin : bulletin
subrayar : souligner
honrado : honnête
falacia : mensonge
vileza : bassesse
volcado : transfert, envoi
cohecho : corruption
pinza : pince
expectacion : attente
quiniela : grille de loto
portada : couverture, première page
saldar : solder
pellejo : peau
ruborizar : rougir
caricia : caresse
forastero : étranger
arropar : couvrir, emmitoufler
transcurso : cours, passage (temps)
alba : aube
sarten : poêle
parir : accoucher de
semejanza : ressemblance
tieso : raide, droit
camison : chemise de nuit
amamantar : allaiter
bulla : vacarme
alboroto : tapage, vacarme
alumbramiento : accouchement
pezon : téton
sabiduria : savoir
liebre : lièvre
tijeras : ciseaux
palmada : tape
trajin : agitation
pudoroso : pudique
curiosear : fouiner
acartonar : durcir
rinon : rein
chiquillo : enfant
manso : doux, paisible
carestia : pénurie
cacharro : casserole
estufa : radiateur, chauffage
jaula : cage
costado : côte
consuelo : consolation
calloso : rugueux
sufragar : financer
plomero : plombier
preso : prisonnier
amparar : protéger
hosco : bourru
piedad : pitié
congoja : angoisse
ternura : tendresse
inconmovible : inébranlable
rascar : gratter
huerto : potager
zurcir : raccommoder
parche : rustine
tejer : tisser
absortar : étonner
nitido : net
manta : couverture
parchar : réparer
botar : jeter
abrumar : accabler
tela : tissu
remiendo : pièce
desprender : détacher
costra : croûte
chaleco : gilet
hebra : fil
peregrino : voyageur
rana : grenouille
estanque : étang
resbalar : glisser
regar : arroser
destripar : étriper
musgo : mousse
cesantia : cessation d'activité
desperdicio : détritus, déchet
loza : vaisselle
estrepito : vacarme
quebrar : briser, casser
balde : seau
doblar : plier
espumajo : salive
estremecer : ébranler
verter : verser
afan : efforts, ardeur
zozobra : angoisse
vano : vain
repudiar : rejeter, repousser
noviazgo : relation amoureuse
prejuicio : préjugé
cautivar : captiver
benefactor : bienfaiteur
suspicacia : suspicion, méfiance
cuchichear : chuchoter
deslizar : faire glisser
perra : colère
cerro : tas
desparramar : étaler, répandre
maldecir : maudire
plateado : argenté
andanada : engueulade
aborrecer : détester
tregua : trêve
dictaminar : décréter
soberbia : orgueil
arrebatar : arracher
apaciguar : apaiser
sobresalto : sursaut
incertidumbre : incertitude
ombligo : nombril
embuste : mensonge
defuncion : décès
escurrir : couler
hacerse humo : partir en fumée
pasarela : passerelle
adecuar : adapter
grada : marche
resarcirse : obtenir réparation
affliccion : peine, chagrin
felonia : crime
escabullirse : s'échapper
fiera : bête féroce
atesorar : accumuler
truhaneria : truanderie
despilfarro : gaspillage
rasgos : traits, physionomie
desparpajo : aisance
barniz : apparence
linaje : lignée
descabellado : fou, insensé
trepar : grimper
hostigar : harcerler
atadura : attache
panuelo : foulard
tumbar : renverser
aduana : douane
prescindir de : se passer de
desmantelar : démanteler
arancel : droit de douane
incentivar : stimuler, encourager
recorte : coupe budgétaire
sembrar : semer
inmune : immunisé
aflojar : desserrer, détendre
caducar : périmer
lema : devise, slogan
demandar : poursuivre
desembocar : déboucher sur
aferrarse : s'accrocher
denegar : refuser, rejeter
coraje : courage
balacera : fusillade
brecha : brèche, fissure
aforo : capacité
escarnio : humiliation, moquerie
encarar : faire face à
lidiar : combattre, faire face à
periodo de prueba : période d'essai
esquematico : schématique
pedido : commande
a corto plazo : à court terme
liquidez : liquidité
recomponer : recomposer
sabana : drap
fluir : couler
escalar : escalader
desafio : défi
chocar : percuter
desleal : déloyal
contundente : contondant
recursos : ressources
aportar : aporter, fournir
aluvion : crue
desplome : effondrement, écroulement
influir : influencer, influer sur
augurar : prédire, présager
mala racha : mauvaise passe
arrastrar : traîner, tirer
cochera : garage
costal : sac
rebote : rebond
barrera : barrière
avalar : se porter garant
ingente : immense, énorme
adjudicaion : attribution
gremio : syndicat
pulso : fermeté
vasco : basque
bulto : bosse, forme
dieta : régime
desapercibido : inaperçu
claraboya : lucarne
ajado : usé
resoplar : souffler
a pesar de : malgré
sastre : couturier
encimera : plan de travail
despejar : dégager
chillido : cri
garrafa : carafe
rollo : baratin
cepillo : brosse
caballo : héroïne, came, chnouf
acera : trottoir
cemento : ciment
soga : corde
chulo : mac
carajo : bordel, merde
