desatar : détacher
tropezar con : trébucher sur, se cogner contre
asomar : apparaître, pointer le bout de son nez
dichoso : heureux, chanceux
falda : flanc
dichoso : foutu, satané, maudit
resguardarse : se protéger, s'abriter
manojo : bouquet (de fleurs), trousseau (de clés)
arrebujarse : s'emmitoufler
almohada : oreiller
sanar : guérir
apartar : pousser, déplacer, écarter, mettre de côté
santidad : saineté
saudade : nostalgie, mélancolie
cenicienta : cendré (couleur)
al cabo de : au bout de
poniente : couchant
alla : autrefois, jadis
labrar : façonner
cornisa : corniche
escudo : emblême
linaje : lignée
umbral : seuil
estribo : étrier
castano : châtaigner
vidriera : vitrail, vitrine
vidrio : vitre
compareciencia : comparution
desasirse : se libérer de
alzar : lever
nuevamente : de nouveau
ancho : large
losa : dalle, pierre, plaque
lapida : pierre tombale
escano : siège, banc
roble : chêne
lustroso : brillant, lustré
usanza : usage, mode
arcon : coffre
trigo : blé
tapa : couvercle, capuchon
criada : domestique, servant
sendo : important
tertulia : réunion entre amis
digerir : digérer
patear : piétiner
vena : veine
inflar a algo : rouer de coups
hostia : beigne, torgnole, coup
cardenal : bleu, hématome
embajada : ambassade
teja : tuile
mesar : arracher (cheveux, barbe)
desviado : dépravé
guarnicion : garniture
manga : manche
chuparse : maigrir
desalojar : expulser, déloger
tartera : récipient, gamelle
a bulto : à première vue
agudo : aigu, pointu
estallar : éclater, exploser
geranio : géranium
tonelada : tonne
inmerso : immergé, submergé
arrugar : froisser, chiffonner
ojear : jeter un coup d'oeil
varita : baguette
atajo : tricherie
encogerse : se recroqueviller, se replier
sabio : sage
carcajada : éclat de rire
agrio : aigre, âpre, rude
vengador : vengeur
hiena : hyène
descascarillar : poncer, décaper
empotrar : encastrer
atisbar : observer
comparecer : comparaître
ajetreo : agitation, effervescence
impulsar : propulser
avecinarse : s'approcher
aterrizar : atterrir
alza : hausse, augmentation
reforzar : renforcer
plantilla : personnel
flojo : tranquille, calme
dispararse : monter en flèche, exploser
decantarse : opter pour, choisir
bono : bon, obligation
asumir el control : prendre le pouvoir
armamento : armement
disponer de : disposer de
triplicar : tripler
pugna : lutte, bataille
fuselaje : fuselage
amerizar : amerrir
con antelacion : à l'avance, en avance
apurar : finir, terminer
surco : ride
chorro : cavalier
escanciar : verser à boire
desperdicar : gaspiller
atravesarse : s'interposer
a un tiro de pierda : à deux pas
piernas : guignol
estrellar : lancer
marisco : fruits de mer
esbozar : esquisser
aprovechar el tiron : profiter du succès
resuello : souffle, respiration
palanca : levier
apanar : rafistoler, arranger
tragaperras : machine à sous
arraigado : enraciné
renuente : réticent
apremiar : presser, bousculer
adentros : for intérieur, soi-même
raspon : eraflure
boquiabierto : bouche bée